AAFM	AA F M
AAJP	AA JH P
AAM	AA M
AAN	EY AH N
AARM	AH AA R M
AARN	AA R N
AARU	AA R UW
AASM	AA Z AH M
AASN	AA Z N
AASP	AA S
AAST	AA S T
AASU	AA S UW
AASY	AA Z IY
AAU	AA UW
AFO	AE F OW
AI	AY
AI(2)	EY AY
AJCH	AE JH CH
AJT	AE JH T
AM	AE M
AM(2)	EY EH M
AN	AE N
AN(2)	AH N
ANG	AE NG
ANH	AE N
AO	EY OW
ARI	AA R IY
ARM	AA R M
ARNH	AA R N
ARO	AA R OW
ASC	AE S
ASCH	AE SH
ASI	AE S IY
ASM	AE Z AH M
ASN	AE Z N
ASNG	AE Z NG
ASNH	AE Z N
ASO	AE S OW
ASP	AE S P
AST	AE S T
ASY	AH Z IY
AWM	AO M
AWN	AO N
AWSC	AO S
AWSNG	AO S NG
AWSP	AO S
AWST	AO S T
AWXM	AO K S M
BA	B AA
BAAFM	B AA F M
BAAFN	B AA F N
BAAFU	B AA F UW
BAAFY	B AA F IY
BAAJC	B AA JH K
BAAJN	B AA JH N
BAAJP	B AA JH P
BAAJT	B AA JH T
BAAJU	B AA JH UW
BAAJY	B AA JH IY
BAAN	B EY AH N
BAANG	B AA NG
BAARM	B AA R M
BAARN	B AA R N
BAARY	B EY AH R IY
BAASC	B AA S
BAASM	B AA Z AH M
BAASN	B AA Z N
BAASP	B AA S
BAAST	B AA S T
BAASU	B AA S UW
BAASY	B AA Z IY
BAAU	B AA UW
BAAXY	B AA K S IY
BAAY	B AA IY
BAF	B AE F
BAFI	B AE F IY
BAFN	B AE F N
BAFNG	B AE F NG
BAFNH	B AE F N
BAFO	B AE F OW
BAFU	B AE F UW
BAFY	B EY F IY
BAI	B EY
BAJ	B AE JH
BAJC	B AE JH K
BAJCH	B AE JH CH
BAJI	B AE JH IY
BAJN	B AE JH N
BAJNG	B AE JH NG
BAJO	B AE JH OW
BAJT	B AE JH T
BAN	B AE N
BANG	B AE NG
BANH	B AE N
BAO	B AW
BAR	B AA R
BARN	B AA R N
BARNG	B AA R NG
BARNH	B AA R N
BARO	B AA R OW
BARU	B AE R UW
BARY	B IY EH R IY
BAS	B AE Z
BASC	B AE S
BASCH	B AE SH
BASI	B AA S IY
BASI(2)	B EY S IY
BASM	B AE Z AH M
BASN	B AE Z N
BASNG	B AE Z NG
BASNH	B AE Z N
BASO	B AE S OW
BASP	B AE S
BAST	B AE S T
BASU	B AA S UW
BASY	B EY S IY
BAU	B AO
BAWFNG	B AO F NG
BAWJM	B AO JH M
BAWJT	B AO JH T
BAWM	B AO M
BAWN	B AO N
BAWNG	B AO NG
BAWSC	B AO S
BAWSN	B AO S N
BAWSP	B AO S
BAWST	B AO S T
BAWXNG	B AO K S NG
BAX	B AE K S
BAXI	B AE K S IY
BAXNG	B AE K S NG
BAXO	B AE K S OW
BAY	B EY
BE	B IY
BEE	B IY
BEEF	B IY F
BEEFN	B AH EH F N
BEEFNH	B AH EH F N
BEEFU	B AH EH F UW
BEEJ	B AH EH JH
BEEJCH	B AH EH JH CH
BEEJN	B AH EH JH N
BEEJNH	B AH EH JH N
BEEJT	B AH EH JH T
BEEJU	B AH EH JH UW
BEEN	B IH N
BEEN(2)	B AH N
BEENH	B AH EH N
BEER	B IH R
BEES	B IY Z
BEESN	B AH EH Z N
BEESP	B AH EH S
BEEST	B IY AH S T
BEEU	B AH Y UW
BEEX	B AH EH K S
BEF	B EH F
BEFM	B EH F M
BEFN	B EH F N
BEFO	B AH F OW
BEJ	B EH JH
BEJN	B EH JH N
BEJP	B EH JH P
BEJT	B EH JH T
BEN	B EH N
BENG	B EH NG
BEO	B AH OW
BER	B IY ER
BERM	B ER M
BERO	B EH R OW
BES	B IY Z
BESN	B EH Z N
BESO	B AH S OW
BESP	B EH S
BEST	B EH S T
BEX	B EH K S
BEXN	B EH K S N
BI	B AY
BIA	B AY AA
BIEEFN	B AY IY F N
BIEEFU	B AY IY F UW
BIEEJN	B AY IY JH N
BIEEJT	B AY IY JH T
BIEEN	B IY IY AH N
BIEERN	B AY IH R N
BIEERU	B AY IH R UW
BIEESC	B AY IY S
BIEESM	B AY IY Z AH M
BIEESN	B AY IY Z N
BIEESNG	B AY IY Z NG
BIEEST	B IY IY AH S T
BIEESU	B AY IY S UW
BIEEU	B AY IY UW
BIF	B IH F
BIFA	B AY F AA
BIFM	B IH F M
BIFNH	B IH F N
BIFU	B AY F UW
BIJ	B IH JH
BIJA	B AY JH AA
BIJCH	B IH JH CH
BIJN	B IH JH N
BIJNH	B IH JH N
BIJP	B IH JH P
BIJT	B IH JH T
BIJU	B AY JH UW
BIM	B IH M
BIN	B IH N
BINH	B IH N
BIR	B ER
BIRM	B AH R M
BIRNH	B AH R N
BIS	B IH S
BISCH	B IH SH
BISNH	B IH Z N
BIST	B IY IH S T
BISU	B AY S UW
BIX	B IH K S
BIXNH	B IH K S N
BIXU	B AY Z UW
BO	B OW
BOA	B OW AH
BOF	B AA F
BOFN	B AA F N
BOFNG	B AA F NG
BOJ	B AA JH
BOJC	B AA JH K
BOJN	B AA JH N
BOJNG	B AA JH NG
BOJT	B AA JH T
BOM	B AA M
BON	B AA N
BONG	B AA NG
BOO	B UW
BOOF	B UW F
BOOFI	B UW F IY
BOOFN	B UW F N
BOOFNG	B UW F NG
BOOI	B UW IY
BOOJ	B UW JH
BOOJC	B UW JH K
BOOJI	B UW JH IY
BOOJN	B UW JH N
BOOJP	B UW JH P
BOOJT	B UW JH T
BOOM	B UW M
BOON	B UW N
BOONG	B UW NG
BOOR	B UH R
BOORI	B UH R IY
BOORN	B UH R N
BOORNG	B UH R NG
BOOS	B UW Z
BOOSC	B UW S
BOOSI	B UW S IY
BOOSN	B UW Z N
BOOSNG	B UW Z NG
BOOSP	B UW S
BOOST	B UW S T
BOOXNG	B UH K S NG
BOR	B IY ER
BORI	B AO R IY
BORM	B AO R M
BORNG	B AO R NG
BOS	B AA S
BOSC	B AA S
BOSI	B OW S IY
BOSN	B AA Z N
BOSNG	B AA Z NG
BOSP	B AA S
BOST	B AA S T
BOW	B AW
BOW(2)	B OW
BOWF	B OW F
BOWFI	B OW F IY
BOWFM	B OW F M
BOWI	B OW IY
BOWJ	B OW JH
BOWJM	B OW JH M
BOWJN	B OW JH N
BOWM	B OW M
BOWN	B OW N
BOWR	B OW R
BOWRI	B OW R IY
BOWS	B AW Z
BOWS(2)	B OW Z
BOWSI	B OW S IY
BOWST	B OW S T
BOWX	B OW K S
BOWXN	B OW K S N
BOX	B AA K S
BOXM	B AA K S M
BOXNG	B AA K S NG
BU	B UW
BUA	B Y UW AH
BUA(2)	B IY Y UW EY
BUF	B AH F
BUFA	B Y UW F AH
BUFI	B Y UW F IY
BUFN	B AH F N
BUFNG	B AH F NG
BUI	B IH
BUI(2)	B W IY
BUJ	B AH JH
BUJA	B Y UW JH AH
BUJC	B AH JH K
BUJI	B Y UW JH IY
BUJNG	B AH JH NG
BUJP	B AH JH P
BUJT	B AH JH T
BUN	B AH N
BUNG	B AH NG
BUOOFI	B Y UW AH F IY
BUOOFM	B Y UW UW F M
BUOOFN	B Y UW UW F N
BUOOFNG	B Y UW UW F NG
BUOOJC	B Y UW UW JH K
BUOOJT	B Y UW UW JH T
BUOON	B Y UW UW N
BUOONG	B Y UW UW NG
BUOORI	B Y UW AH R IY
BUOOST	B Y UW UW S T
BURN	B ER N
BURNG	B AH R NG
BUS	B AH S
BUSA	B Y UW S AH
BUSN	B AH Z N
BUSNG	B AH Z NG
BUSP	B AH S
BUST	B AH S T
BUWFA	B AH W F AH
BUWFNG	B AH W F NG
BUWJ	B AH W JH
BUWJA	B AH W JH AH
BUWJC	B AH W JH K
BUWNG	B AH W NG
BUWOWI	B AH W OW IY
BUWOWM	B AH W OW M
BUWOWNG	B AH W OW NG
BUWOWRI	B AH W OW R IY
BUWOWSC	B AH W OW S
BUWOWSM	B AH W OW Z AH M
BUWOWSNG	B AH W OW S NG
BUWOWSU	B AH W OW S UW
BUWOWU	B AH W OW UW
BUWRA	B AH W R AH
BUWRU	B AH W R UW
BUWSC	B AH W S
BUWSNG	B AH W S NG
BUWST	B AH W S T
BUWU	B AH W UW
BUWXA	B AH W K S AH
BUYST	B Y UW AH S T
CA	K AH
CA(2)	S IY EY
CA(3)	K AA
CAAFM	K AA F M
CAAFN	K AA F N
CAAFU	K AA F UW
CAAFY	K AA F IY
CAAJN	K AA JH N
CAAJP	K AA JH P
CAAJT	K AA JH T
CAAJU	K AA JH UW
CAAJY	K AA JH IY
CAAM	K AA M
CAAN	K AA N
CAANG	K AA NG
CAARM	K AA R M
CAARN	K AA R N
CAARU	K AA R UW
CAASC	K AA S
CAASM	K AA Z AH M
CAASN	K AA Z N
CAASP	K AA S
CAAST	K AA S T
CAASU	K AA S UW
CAASY	K AA Z IY
CAAU	K AA UW
CAAXM	K AA K S M
CAAXN	K AA K S N
CAAXNG	K AA K S NG
CAAXU	K AA K S UW
CAAY	K AA IY
CAF	K AE F
CAFI	K AE F IY
CAFN	K AE F N
CAFNG	K AE F NG
CAFNH	K AE F N
CAFO	K AE F OW
CAFU	K AE F UW
CAFY	K AE F EY IY
CAI	K AY
CAJ	K AE JH
CAJC	K AE JH K
CAJCH	K AE JH CH
CAJM	K AE JH M
CAJN	K AE JH N
CAJNH	K AE JH N
CAJO	K AE JH OW
CAJP	K AE JH P
CAJY	K EY JH IY
CAM	K AE M
CAN	K AE N
CAN(2)	K AH N
CANG	K AE NG
CANH	K AE N
CAO	K AW
CAR	K AA R
CARI	K AE R IY
CARM	K AA R M
CARN	K AA R N
CARNG	K AA R NG
CARNH	K AA R N
CARO	K AA R OW
CAS	K AE S
CASC	K AE S
CASCH	K AE S
CASI	K AE S IY
CASM	K AE Z AH M
CASN	K AE Z N
CASNG	K AE Z NG
CASNH	K AE Z N
CASO	K AA S OW
CASP	K AE S
CAST	K AE S T
CASU	K AE S UW
CASY	K EY S IY
CAU	K AW
CAU(2)	K OW
CAWFM	K AO F M
CAWFN	K AO F N
CAWJC	K AO JH K
CAWJM	K AO JH M
CAWJN	K AO JH N
CAWJP	K AO JH P
CAWJT	K AO JH T
CAWM	K AO M
CAWN	K AO N
CAWNG	K AO NG
CAWRNG	K AO R NG
CAWSC	K AO S
CAWSM	K AO Z AH M
CAWSN	K AO S N
CAWSP	K AO S
CAWST	K AO S T
CAXI	K AE K S IY
CAY	K EY
CHA	CH AA
CHAAFN	CH AA F N
CHAAFU	CH AA F UW
CHAAFY	CH AA F IY
CHAAJM	CH AA JH M
CHAAJN	CH AA JH N
CHAAJP	CH AA JH P
CHAAJT	CH AA JH T
CHAAJU	CH AA JH UW
CHAAM	CH AA M
CHAAN	CH EY AH N
CHAARN	CH AA R N
CHAASM	CH AA Z AH M
CHAASN	CH AA Z N
CHAASP	CH AA S
CHAAST	CH AA S T
CHAASU	CH AA S UW
CHAASY	CH AA Z IY
CHAAU	CH AA UW
CHAF	CH AE F
CHAFI	CH AE F IY
CHAFM	CH AE F M
CHAFNG	CH AE F NG
CHAFNH	CH AE F N
CHAFO	CH AE F OW
CHAFY	CH EY F IY
CHAI	CH AY
CHAJ	CH AE JH
CHAJC	CH AE JH K
CHAJCH	CH AE JH CH
CHAJM	CH AE JH M
CHAJN	CH AE JH N
CHAJNG	CH AE JH NG
CHAJNH	CH AE JH N
CHAJO	CH AE JH OW
CHAJP	CH AE JH P
CHAJY	CH EY JH IY
CHAM	CH AE M
CHAN	CH AE N
CHANG	CH AE NG
CHANH	CH AE N
CHAO	CH AW
CHAR	CH AA R
CHARI	CH AE R IY
CHARNH	CH AA R N
CHARO	CH AE R OW
CHARY	CH AA R IY
CHAS	CH AA Z
CHASC	CH AE S
CHASN	CH AE Z N
CHASNG	CH AE Z NG
CHASNH	CH AE Z N
CHASO	CH AE S OW
CHAST	CH AE S T
CHASU	CH AE S UW
CHASY	CH EY S IY
CHAU	SH OW
CHAWFM	CH AO F M
CHAWFNG	CH AO F NG
CHAWJC	CH AO JH K
CHAWJM	CH AO JH M
CHAWJN	CH AO JH N
CHAWJNG	CH AO JH NG
CHAWJP	CH AO JH P
CHAWJT	CH AO JH T
CHAWM	CH AO M
CHAWN	CH AO N
CHAWNG	CH AO NG
CHAWRNG	CH AO R NG
CHAWSC	CH AO S
CHAWSM	CH AO Z AH M
CHAWSN	CH AO S N
CHAWSP	CH AO S
CHAWST	CH AO S T
CHAWXN	CH AO K S N
CHAX	CH AE K S
CHAXO	CH AE K S OW
CHAY	CH EY IY
CHE	CH EY
CHEE	CH IY
CHEEF	CH IY F
CHEEJ	CH IY JH
CHEEJCH	CH IY JH CH
CHEEJNH	CH IY JH N
CHEEM	CH IY M
CHEENH	CH IY N
CHEERNH	CH IH R N
CHEES	CH IY Z
CHEESCH	CH IY S
CHEEST	CH IY AH S T
CHEEXM	CH IY K S M
CHEF	SH EH F
CHEFN	CH EH F N
CHEFO	CH EH F OW
CHEJ	CH EH JH
CHEJT	CH EH JH T
CHEN	CH EH N
CHEO	CH IY OW
CHER	SH EH R
CHES	CH EH S
CHESM	CH EH Z AH M
CHESN	CH EH Z N
CHESNG	CH EH Z NG
CHESO	CH EH S OW
CHESP	CH EH S
CHEST	CH EH S T
CHEX	CH EH K S
CHEXN	CH EH K S N
CHI	K AY
CHIA	CH IY AH
CHIEEFN	CH IY AH F N
CHIEEFNG	CH IY AH F NG
CHIEEFU	CH IY AH F UW
CHIEEM	CH IY AH M
CHIEEN	CH IY AH N
CHIEENG	CH IY AH NG
CHIEERU	CH IY AH R UW
CHIEESC	CH IY AH S
CHIEESM	CH IY AH Z AH M
CHIEESN	CH IY AH Z N
CHIEESNG	CH IY AH Z NG
CHIEEST	CH IY AH S T
CHIEESU	CH IY AH S UW
CHIEEU	CH IY UW
CHIF	CH IH F
CHIFA	CH IH F AH
CHIFM	CH IH F M
CHIJ	CH IH JH
CHIJT	CH IH JH T
CHIJU	CH IH JH UW
CHIM	CH IH M
CHINH	CH IH N
CHIR	CH IH R
CHIRN	CH AH R N
CHIRNH	CH AH R N
CHIS	K AY Z
CHISCH	CH IH S
CHISM	CH IH Z AH M
CHISN	CH IH Z N
CHISNH	CH IH Z N
CHISP	CH IH S
CHIST	CH IH S T
CHIXA	CH IH K S AH
CHIXNH	CH IH K S N
CHO	CH OW
CHOAFNG	CH OW F NG
CHOAJC	CH OW JH K
CHOAJI	CH OW JH IY
CHOAJNG	CH OW JH NG
CHOANG	CH OW NG
CHOARNG	CH OW R NG
CHOASN	CH OW Z N
CHOASNG	CH OW Z NG
CHOAWST	CH OW W S T
CHOEJT	CH OW AH JH T
CHOFE	CH OW F
CHOFI	CH OW F IY
CHOFM	CH AA F M
CHOFNG	CH AA F NG
CHOI	CH OY
CHOJC	CH AA JH K
CHOJE	CH OW JH
CHOJI	CH OW JH IY
CHOJN	CH AA JH N
CHOJT	CH AA JH T
CHOM	CH AA M
CHONG	CH AO NG
CHOO	CH UW
CHOOF	CH UW F
CHOOFI	CH UW F IY
CHOOFM	CH UW F M
CHOOFN	CH UW F N
CHOOFNG	CH UW F NG
CHOOJP	CH UW JH P
CHOOJT	CH UW JH T
CHOON	CH UW N
CHOONG	CH UW NG
CHOORI	CH UH R IY
CHOORNG	CH UH R NG
CHOOSC	CH UW S
CHOOSI	CH UW S IY
CHOOSN	CH UW Z N
CHOOSNG	CH UW Z NG
CHOOSP	CH UW S
CHOOST	CH UW S T
CHOOX	CH UH K S
CHOR	CH AO R
CHORI	CH AO R IY
CHORM	CH AO R M
CHORNG	CH AO R NG
CHOS	CH AA Z
CHOSC	CH AA S
CHOSE	CH OW Z
CHOSI	CH OW S IY
CHOSNG	CH AA Z NG
CHOSP	CH AA S
CHOST	CH AA S T
CHOW	CH AW
CHOWF	CH OW F
CHOWFN	CH OW F N
CHOWI	CH OW IY
CHOWJ	CH OW JH
CHOWJT	CH OW JH T
CHOWM	CH OW M
CHOWN	CH OW N
CHOWR	CH OW R
CHOWRM	CH OW R M
CHOWS	CH AW Z
CHOWSI	CH OW S IY
CHOWSM	CH OW Z AH M
CHOWSN	CH OW S N
CHOWSP	CH OW S
CHOWST	CH OW S T
CHOX	CH AA K S
CHOXNG	CH AA K S NG
CHU	CH UW
CHUA	K UW AH
CHUA(2)	K W AA
CHUAARN	CH UW W AH R N
CHUEES	CH UW AH S
CHUF	CH AH F
CHUFA	CH UW F AH
CHUFI	CH UW F IY
CHUFM	CH AH F M
CHUFN	CH AH F N
CHUFNG	CH AH F NG
CHUFY	CH UW F IY
CHUI	K UW IH
CHUJC	CH AH JH K
CHUJM	CH AH JH M
CHUJP	CH AH JH P
CHUJT	CH AH JH T
CHUM	CH AH M
CHUNG	CH AH NG
CHUOOFN	CH UW W UW F N
CHUOOFNG	CH UW W UW F NG
CHUOOI	CH UW W UW IY
CHUOOJC	CH UW W UW JH K
CHUOOJI	CH UW W AH JH IY
CHUOOJNG	CH UW W UW JH NG
CHUOOJT	CH UW W UW JH T
CHUOOM	CH UW W UW M
CHUOONG	CH UW W UW NG
CHUOOSC	CH UW W UW S
CHUOOSI	CH UW W AH S IY
CHUOOST	CH UW W UW S T
CHUOOXI	CH UW W UH K S IY
CHUR	CH AH R
CHURN	CH ER N
CHURNG	CH AH R NG
CHUS	CH AH Z
CHUSA	CH UW S AH
CHUSC	CH AH S
CHUSI	CH UW S IY
CHUSM	CH AH Z AH M
CHUSNG	CH AH Z NG
CHUST	CH AH S T
CHUW	CH AH W
CHUWA	CH AH W AH
CHUWF	CH AH W F
CHUWFA	CH AH W F AH
CHUWFNG	CH AH W F NG
CHUWJC	CH AH W JH K
CHUWNG	CH AH W NG
CHUWOWFNG	CH AH W OW F NG
CHUWOWJC	CH AH W OW JH K
CHUWOWNG	CH AH W OW NG
CHUWOWRNG	CH AH W OW R NG
CHUWOWSC	CH AH W OW S
CHUWOWSNG	CH AH W OW S NG
CHUWR	CH AH W R
CHUWRA	CH AH W R AH
CHUWRI	CH AH W R IY
CHUWRNG	CH AH W R NG
CHUWS	CH AH W Z
CHUWSA	CH AH W S AH
CHUWSC	CH AH W S
CHUWSNG	CH AH W S NG
CHUWX	CH AH W K S
CHUWXA	CH AH W K S AH
CHUWXNG	CH AH W K S NG
CHUXM	CH AH K S M
CHUXN	CH AH K S N
CHUYEEFN	CH UW W AY IY F N
CHUYEEJN	CH UW W AY IY JH N
CHUYEEN	CH UW W AY IY AH N
CHUYEERN	CH UW W AY AH R N
CHUYEESN	CH UW W AY IY Z N
CHUYEEST	CH UW W AY IY AH S T
CO	K OW
COF	K AA F
COFI	K OW F IY
COFM	K AA F M
COFN	K AA F N
COFNG	K AA F NG
COI	K OW IY
COJ	K AA JH
COJC	K AA JH K
COJM	K AA JH M
COJN	K AA JH N
COJNG	K AA JH NG
COJP	K AA JH P
COJT	K AA JH T
COM	K AA M
CON	K AA N
CONG	K AO NG
COO	K UW
COOF	K OW AA F
COOFM	K OW AA F M
COOFN	K OW AA F N
COOFNG	K OW AA F NG
COOI	K OW OY
COOJ	K OW AA JH
COOJC	K OW AA JH K
COOJI	K OW AA JH IY
COOJM	K OW AA JH M
COOJNG	K OW AA JH NG
COOJP	K OW AA JH P
COOJT	K OW AA JH T
COON	K UW N
COONG	K OW AO NG
COOOOSNG	K OW UW AH Z NG
COOR	K OW AH R
COORI	K OW AO R IY
COORN	K OW AO R N
COORNG	K OW AO R NG
COOS	K UW S
COOSC	K OW AA S
COOSI	K OW AA S IY
COOSM	K OW AA Z AH M
COOSNG	K OW AA Z NG
COOSP	K OW AA S
COOST	K OW AA S T
COOX	K OW AA K S
COOXI	K OW AA K S IY
COR	K AO R
CORI	K OW R IY
CORN	K AO R N
COS	K AO S
COSC	K AA S
COSI	K OW S IY
COSNG	K AA Z NG
COSP	K AA S
COST	K AA S T
COST(2)	K AO S T
COW	K AW
COWF	K OW F
COWFI	K OW W F IY
COWI	K OW W IY
COWJN	K OW JH N
COWJT	K OW JH T
COWM	K OW M
COWN	K OW N
COWRI	K OW R IY
COWS	K AW Z
COWSM	K OW Z AH M
COWX	K OW K S
COWXI	K OW W K S IY
COWXN	K OW K S N
COXI	K OW Z IY
COXNG	K AA K S NG
CU	K UW
CUA	K Y UW AH
CUF	K AH F
CUFA	K Y UW F AH
CUFI	K Y UW F IY
CUFM	K AH F M
CUFN	K AH F N
CUFNG	K AH F NG
CUI	K UW
CUJ	K AH JH
CUJC	K AH JH K
CUJI	K Y UW JH IY
CUJM	K AH JH M
CUJP	K AH JH P
CUJT	K AH JH T
CUN	K AH N
CUNG	K AH NG
CUOOFN	K Y UW UW F N
CUOOFNG	K Y UW UW F NG
CUOOJC	K Y UW UW JH K
CUOOJI	K Y UW AH JH IY
CUOOJN	K Y UW UW JH N
CUOONG	K Y UW UW NG
CUOOSC	K Y UW UW S
CUOOSI	K Y UW AH S IY
CUOOSN	K Y UW UW Z N
CUOOSNG	K Y UW UW Z NG
CUOOXM	K Y UW AH K S M
CUR	K ER
CURA	K Y UH R AH
CURI	K Y UH R IY
CURN	K AH R N
CURNG	K AH R NG
CUS	K AH S
CUS(2)	S IY Y UW EH S
CUSC	K AH S
CUSI	K Y UW S IY
CUSM	K AH Z AH M
CUSNG	K AH Z NG
CUSP	K AH S P
CUST	K AH S T
CUW	K AH W
CUWA	K AH W AH
CUWF	K AH W F
CUWFU	K AH W F UW
CUWJ	K AH W JH
CUWJA	K AH W JH AH
CUWJC	K AH W JH K
CUWJU	K AH W JH UW
CUWNG	K AH W NG
CUWOWFI	K AH W OW F IY
CUWOWFM	K AH W OW F M
CUWOWFNG	K AH W OW F NG
CUWOWNG	K AH W OW NG
CUWOWSC	K AH W OW S
CUWOWSI	K AH W OW S IY
CUWOWSP	K AH W OW S
CUWOWXI	K AH W OW K S IY
CUWOWXNG	K AH W OW K S NG
CUWR	K AH W R
CUWRA	K AH W R AH
CUWRI	K AH W R IY
CUWRU	K AH W R UW
CUWS	K AH W Z
CUWSA	K AH W S AH
CUWSC	K AH W S
CUWSNG	K AH W S NG
CUWST	K AH W S T
CUWSU	K AH W S UW
CUWU	K AH W UW
CUWX	K AH W K S
CUWXU	K AH W K S UW
CUX	K AH K S
CUXI	K AH K S IY
CUXN	K AH K S N
CUXNG	K AH K S NG
DA	D AA
DA(2)	D IY EY
DAAFM	D AA F M
DAAFN	D AA F N
DAAFU	D AA F UW
DAAFY	D AA F IY
DAAJM	D AA JH M
DAAJN	D AA JH N
DAAJP	D AA JH P
DAAJT	D AA JH T
DAAJY	D AA JH IY
DAAM	D AA M
DAAN	D EY AH N
DAANG	D AA NG
DAARM	D AA R M
DAARN	D AA R N
DAASN	D AA Z N
DAASP	D AA S
DAASU	D AA S UW
DAASY	D AA Z IY
DAAU	D AA UW
DAAXN	D AA K S N
DAAXY	D AA K S IY
DAAY	D AA IY
DAFI	D AE F IY
DAFN	D AE F N
DAFNG	D AE F NG
DAFNH	D AE F N
DAFO	D AE F OW
DAFU	D AE F UW
DAFY	D EY F IY
DAI	D AY
DAJ	D AE JH
DAJC	D AE JH K
DAJI	D AE JH IY
DAJM	D AE JH M
DAJN	D AE JH N
DAJNG	D AE JH NG
DAJO	D AE JH OW
DAJT	D AE JH T
DAJY	D EY JH IY
DAN	D AE N
DANG	D AE NG
DANH	D AE N
DAO	D AW
DARI	D AE R IY
DASI	D AE S IY
DASM	D AE Z AH M
DASN	D AE Z N
DASNG	D AE Z NG
DAST	D AE S T
DASY	D EY Z IY
DAWFM	D AO F M
DAWFN	D AO F N
DAWFNG	D AO F NG
DAWJC	D AO JH K
DAWJM	D AO JH M
DAWJN	D AO JH N
DAWJT	D AO JH T
DAWM	D AO M
DAWNG	D AO NG
DAWRNG	D AO R NG
DAWST	D AO S T
DAX	D AE K S
DAXI	D AE K S IY
DAXY	D AE K S IY
DAY	D EY
DDA	D AA
DDAAFM	D AA F M
DDAAFN	D AA F N
DDAAFU	D AA F UW
DDAAFY	D AA F IY
DDAAJM	D AA JH M
DDAAJN	D AA JH N
DDAAJP	D AA JH P
DDAAJT	D AA JH T
DDAAJU	D AA JH UW
DDAAJY	D AA JH IY
DDAAM	D AA M
DDAARU	D AA R UW
DDAARY	D EY AH R IY
DDAASM	D AA Z AH M
DDAAST	D AA S T
DDAASU	D AA S UW
DDAASY	D AA Z IY
DDAAU	D AA UW
DDAAXM	D AA K S M
DDAAXN	D AA K S N
DDAAXY	D AA K S IY
DDAAY	D AA IY
DDAF	D AE F
DDAFI	D AE F IY
DDAFM	D AE F M
DDAFN	D AE F N
DDAFNG	D AE F NG
DDAFNH	D AE F N
DDAFO	D AE F OW
DDAFY	D EY F IY
DDAI	D EY
DDAJC	D AE JH K
DDAJCH	D AE JH CH
DDAJI	D AE JH IY
DDAJM	D AE JH M
DDAJN	D AE JH N
DDAJO	D AE JH OW
DDAJP	D AE JH P
DDAJT	D AE JH T
DDAM	D AE M
DDAN	D AE N
DDANG	D AE NG
DDANH	D AE N
DDAO	D EY OW
DDAR	D AA R
DDARM	D AA R M
DDARN	D AA R N
DDARNG	D AA R NG
DDARNH	D AA R N
DDARO	D AE R OW
DDAS	D AE Z
DDASC	D AE S
DDASI	D AE S IY
DDASM	D AE Z AH M
DDASN	D AE Z N
DDASNG	D AE Z NG
DDASNH	D AE Z N
DDASO	D AE S OW
DDASP	D AE S
DDAST	D AE S T
DDASY	D EY Z IY
DDAU	D AO
DDAWFNG	D AO F NG
DDAWJC	D AO JH K
DDAWJN	D AO JH N
DDAWJNG	D AO JH NG
DDAWJT	D AO JH T
DDAWM	D AO M
DDAWNG	D AO NG
DDAWRNG	D AO R NG
DDAWSC	D AO S
DDAWSM	D AO Z AH M
DDAWSN	D AO S N
DDAWSNG	D AO S NG
DDAWSP	D AO S
DDAWST	D AO S T
DDAWXN	D AO K S N
DDAWXNG	D AO K S NG
DDAX	D AE K S
DDAXI	D AE K S IY
DDAXNG	D AE K S NG
DDAY	D EY IY
DDE	D IY
DDEE	D IY
DDEEF	D IY F
DDEEFM	D IY F M
DDEEFN	D IY F N
DDEEFU	D IY F UW
DDEEJ	D IY JH
DDEEJM	D IY JH M
DDEEM	D IY M
DDEENH	D IY N
DDEER	D IY AH R
DDEERU	D IH R UW
DDEES	D IY Z
DDEESM	D IY Z AH M
DDEESN	D IY Z N
DDEEU	D IY UW
DDEEX	D IY K S
DDEEXNH	D IY K S N
DDEF	D EH F
DDEFN	D EH F N
DDEFO	D EH F OW
DDEJP	D EH JH P
DDEJT	D EH JH T
DDEM	D EH M
DDEN	D EH N
DDENG	D EH NG
DDEO	D IY OW
DDER	D EH R
DDESO	D EH S OW
DDEST	D EH S T
DDEXO	D EH K S OW
DDI	D IY
DDIEEFM	D IY AH F M
DDIEEFN	D IY AH F N
DDIEEFU	D IY AH F UW
DDIEEJN	D IY AH JH N
DDIEEJP	D IY AH JH P
DDIEEJT	D IY AH JH T
DDIEEJU	D IY AH JH UW
DDIEEN	D IY AH N
DDIEENG	D IY AH NG
DDIEERM	D IY AH R M
DDIEERN	D IY AH R N
DDIEERU	D IY AH R UW
DDIEESC	D IY AH S
DDIEESM	D IY AH Z AH M
DDIEESU	D IY AH S UW
DDIEEU	D IY UW
DDIF	D IH F
DDIFA	D IH F AH
DDIFN	D IH F N
DDIFNH	D IH F N
DDIFU	D IH F UW
DDIJA	D IH JH AH
DDIJCH	D IH JH CH
DDIJNH	D IH JH N
DDIJT	D IH JH T
DDINH	D IH N
DDIR	D IH R
DDIRA	D IH R AH
DDIRNH	D AH R N
DDISCH	D IH S
DDISNH	D IH Z N
DDIST	D IH S T
DDIU	D AY UW
DDIX	D IH K S
DDIXA	D IH K S AH
DDIXNH	D IH K S N
DDO	D OW
DDOAFI	D OW F IY
DDOAFN	D OW F N
DDOAJN	D OW JH N
DDOAJT	D OW JH T
DDOAN	D OW AH N
DDOARN	D OW R N
DDOASI	D OW S IY
DDOASN	D OW Z N
DDOF	D AA F
DDOFI	D AA F IY
DDOFN	D AA F N
DDOJ	D AA JH
DDOJA	D AA JH AH
DDOJC	D AA JH K
DDOJI	D AA JH IY
DDOJNG	D AA JH NG
DDOJT	D AA JH T
DDOM	D AA M
DDONG	D AO NG
DDOO	D UW
DDOOF	D UW F
DDOOFI	D UW F IY
DDOOFM	D UW F M
DDOOFN	D UW F N
DDOOFNG	D UW F NG
DDOOI	D UW IY
DDOOJ	D UW JH
DDOOJC	D UW JH K
DDOOJI	D UW JH IY
DDOOJN	D UW JH N
DDOOJNG	D UW JH NG
DDOOJP	D UW JH P
DDOOJT	D UW JH T
DDOON	D UW N
DDOONG	D UW NG
DDOOR	D OW AH R
DDOORI	D UH R IY
DDOORNG	D UH R NG
DDOOS	D UW Z
DDOOSC	D UW S
DDOOSI	D UW S IY
DDOOSM	D UW Z AH M
DDOOSN	D UW Z N
DDOOSNG	D UW Z NG
DDOOSP	D UW S
DDOOST	D UW S T
DDOOX	D UH K S
DDOOXI	D UH K S IY
DDOOXNG	D UH K S NG
DDOR	D AO R
DDORM	D AO R M
DDOS	D AA Z
DDOSI	D AA S IY
DDOSM	D AA Z AH M
DDOSN	D AA Z N
DDOSNG	D AA Z NG
DDOW	D OW
DDOWF	D OW F
DDOWFI	D OW F IY
DDOWFM	D OW F M
DDOWJ	D OW JH
DDOWJI	D OW JH IY
DDOWJT	D OW JH T
DDOWM	D OW M
DDOWN	D OW N
DDOWRM	D OW R M
DDOWSI	D OW S IY
DDOWSN	D OW S N
DDOWSP	D OW S
DDOWST	D OW S T
DDOWX	D OW K S
DDU	D UW
DDUA	D Y UW AH
DDUF	D AH F
DDUFA	D Y UW F AH
DDUFI	D Y UW F IY
DDUFM	D AH F M
DDUFN	D AH F N
DDUFNG	D AH F NG
DDUI	D UW
DDUJ	D AH JH
DDUJC	D AH JH K
DDUJN	D AH JH N
DDUJNG	D AH JH NG
DDUN	D AH N
DDUOOI	D Y UW UW IY
DDUOOJI	D Y UW AH JH IY
DDUOORI	D Y UW AH R IY
DDUOOSC	D Y UW UW S
DDUOOSI	D Y UW AH S IY
DDUOOSNG	D Y UW UW Z NG
DDUR	D AH R
DDUSC	D AH S
DDUSNG	D AH Z NG
DDUSP	D AH S
DDUST	D AH S T
DDUWA	D AH W AH
DDUWF	D AH W F
DDUWFNG	D AH W F NG
DDUWJC	D AH W JH K
DDUWJNG	D AH W JH NG
DDUWOWFI	D AH W OW F IY
DDUWOWFNG	D AH W OW F NG
DDUWOWJC	D AH W OW JH K
DDUWOWNG	D AH W OW NG
DDUWSA	D AH W S AH
DDUWSC	D AH W S
DDUWSNG	D AH W S NG
DDUWST	D AH W S T
DDUXA	D AH K S AH
DDUYSCH	D Y UW AH S
DE	D IY
DE(2)	D EY
DE(3)	D AH
DEE	D IY
DEEF	D IY EH F
DEEFN	D IY EH F N
DEEFNH	D IY EH F N
DEEJT	D IY EH JH T
DEEJU	D IY EH JH UW
DEER	D IH R
DEES	D IY Z
DEEST	D IY AH S T
DEEX	D IY EH K S
DEF	D EH F
DEJM	D EH JH M
DEJP	D EH JH P
DER	D ER
DERO	D AH R OW
DESO	D AH S OW
DESP	D EH S
DI	D IY
DI(2)	D AY
DIEEFU	D IY AH F UW
DIEEJC	D IY AH JH K
DIEEJM	D IY AH JH M
DIEEJN	D IY AH JH N
DIEEJP	D IY AH JH P
DIEEJT	D IY AH JH T
DIEEJU	D IY AH JH UW
DIEEM	D IY AH M
DIEEN	D AY AH N
DIEESP	D IY AH S
DIEEST	D AY AH S T
DIEEU	D IY UW
DIEEXM	D IY AH K S M
DIEEXN	D IY AH K S N
DIEEXU	D IY EH K S UW
DIF	D IH F
DIFM	D IH F M
DIFM(2)	D IY AY EH F EH M
DIFU	D IH F UW
DIJ	D IH JH
DIJCH	D IH JH CH
DIJP	D IH JH P
DIJU	D IH JH UW
DIM	D IH M
DIN	D IH N
DINH	D IH N
DIR	D IH R
DIS	D IH S
DISNH	D IH Z N
DISU	D AH S UW
DIU	D AY UW
DIX	D IH K S
DIXA	D IH K S AH
DIXN	D IH K S N
DIXNH	D IH K S N
DO	D UW
DOAFNH	D OW F N
DOANH	D OW N
DOAXN	D OW K S N
DOF	D AA F
DOFM	D AA F M
DOFNG	D AA F NG
DOI	D OY
DOJA	D OW JH AH
DOJC	D AA JH K
DOJN	D AA JH N
DOM	D AA M
DON	D AA N
DONG	D AO NG
DONG(2)	D AO NG G
DOOFI	D UW F IY
DOOFN	D UW F N
DOOJI	D UW JH IY
DOOJNG	D UW JH NG
DOOJT	D UW JH T
DOONG	D UW NG
DOORI	D UH R IY
DOOSC	D UW S
DOOSI	D UW S IY
DOOSNG	D UW Z NG
DOOST	D UW S T
DOOX	D UW AA K S
DOOXI	D UH K S IY
DORM	D AO R M
DORNG	D AO R NG
DOS	D AO S
DOS(2)	D OW S
DOSC	D AA S
DOW	D AW
DOWFI	D OW F IY
DOWI	D OW IY
DOWJN	D OW JH N
DOWN	D AW N
DOWR	D OW R
DOWS	D AW Z
DOWSP	D OW S
DOWX	D OW K S
DOXI	D AA K S IY
DOXNG	D AA K S NG
DU	D UW
DU(2)	D AH
DUA	D Y UW AH
DUAAJT	D Y UW AH JH T
DUEEFNH	D Y UW AH AH F N
DUEEJ	D Y UW AH AH JH
DUF	D AH F
DUFI	D Y UW F IY
DUFM	D AH F M
DUFNG	D AH F NG
DUJ	D AH JH
DUJC	D AH JH K
DUJM	D AH JH M
DUJNG	D AH JH NG
DUNG	D AH NG
DUOOFN	D Y UW UW F N
DUOOSC	D Y UW UW S
DUOOXI	D Y UW UH K S IY
DUSM	D AH Z AH M
DUST	D AH S T
DUW	D AH W
DUWA	D AH W AH
DUWFA	D AH W F AH
DUWFNG	D AH W F NG
DUWJ	D AH W JH
DUWJA	D AH W JH AH
DUWJC	D AH W JH K
DUWJNG	D AH W JH NG
DUWNG	D AH W NG
DUWOWFNG	D AH W OW F NG
DUWOWJC	D AH W OW JH K
DUWOWJI	D AH W OW JH IY
DUWOWJNG	D AH W OW JH NG
DUWOWJT	D AH W OW JH T
DUWOWNG	D AH W OW NG
DUWOWSI	D AH W OW S IY
DUWOWXNG	D AH W OW K S NG
DUWRNG	D AH W R NG
DUWS	D AH W Z
DUWSA	D AH W S AH
DUWST	D AH W S T
DUWX	D AH W K S
DUX	D AH K S
DUXA	D AH K S AH
DUXI	D AH K S IY
DUXNG	D AH K S NG
DUY	D UW IY
DUYEEJT	D Y UW AY IY JH T
DUYEEN	D Y UW AY IY AH N
DY	D AY
DYSN	D IH Z N
EEFNH	IY F N
EEJN	IY JH N
EEJP	IY JH P
EEM	IY M
EESCH	IY S
EESM	IY Z AH M
EESP	IY S
EEU	IY UW
EEXNH	IY K S N
EFO	EH F OW
EJO	EH JH OW
EJP	EH JH P
EJT	EH JH T
EM	EH M
EN	EH N
ENG	EH NG
EO	IY OW
ERN	AH R N
ERO	IH R OW
ESC	EH S
ESM	EH Z AH M
ESN	EH Z N
ESO	EH S OW
ESP	EH S
EST	EH S T
EXO	IH G Z OW
GA	G AA
GA(2)	JH IY EY
GA(3)	JH AO R JH AH
GAAFM	G AA F M
GAAFN	G AA F N
GAAFU	G AA F UW
GAAFY	G AA F IY
GAAJM	G AA JH M
GAAJN	G AA JH N
GAAJP	G AA JH P
GAAJT	G AA JH T
GAAJY	G AA JH IY
GAAN	G EY AH N
GAARM	G AA R M
GAASC	G AA S
GAASM	G AA Z AH M
GAASN	G AA Z N
GAASP	G AA S
GAASU	G AA S UW
GAASY	G AA Z IY
GAAU	G AA UW
GAAXM	G AA K S M
GAAXU	G AA K S UW
GAAXY	G AA K S IY
GAAY	G AA IY
GAF	G AE F
GAFI	G AE F IY
GAFN	G AE F N
GAFNG	G AE F NG
GAFNH	G AE F N
GAFO	G AE F OW
GAFU	G AE F UW
GAFY	G EY F IY
GAI	G EY
GAJ	G AE JH
GAJC	G AE JH K
GAJCH	G AE JH CH
GAJN	G AE JH N
GAJO	G AE JH OW
GAJT	G AE JH T
GAJY	G EY JH IY
GAM	G AE M
GAN	G AE N
GANG	G AE NG
GANH	G AE N
GAO	G EY OW
GAR	G AA R
GARY	G EH R IY
GARY(2)	G AE R IY
GAS	G AE S
GASC	G AE S
GASI	G AE S IY
GASN	G AE Z N
GASNH	G AE Z N
GASO	G AE S OW
GASP	G AE S P
GASU	G AE S UW
GASY	G AE S IY
GAU	G OW
GAWFM	G AO F M
GAWJC	G AO JH K
GAWJM	G AO JH M
GAWJNG	G AO JH NG
GAWJP	G AO JH P
GAWJT	G AO JH T
GAWM	G AO M
GAWNG	G AO NG
GAWSM	G AO Z AH M
GAWSN	G AO S N
GAWSNG	G AO S NG
GAWSP	G AO S
GAWST	G AO S T
GAX	G AE K S
GAXI	G AE K S IY
GAXY	G AE K S IY
GAY	G EY
GHE	G IY
GHEE	G IY
GHEEF	G IY F
GHEEFNH	G IY F N
GHEEJ	G IY JH
GHEEJT	G IY JH T
GHEERNH	G IH R N
GHEES	G IY Z
GHEESCH	G IY S
GHEF	G EH F
GHEFN	G EH F N
GHEJ	G EH JH
GHEJO	G EH JH OW
GHEN	G EH N
GHER	G EH R
GHES	G Z
GHESM	G EH Z AH M
GHESP	G EH S
GHEST	G EH S T
GHEX	G EH K S
GHI	G IY
GHIEEFN	G IY AH F N
GHIEESC	G IY AH S
GHIF	G IH F
GHIFM	G IH F M
GHIM	G IH M
GHISN	G IH Z N
GIA	JH AY AH
GIAAFM	JH AY AH AH F M
GIAAFN	JH AY AH AH F N
GIAAFU	JH AY AE AH F UW
GIAAFY	JH AY AE AH F IY
GIAAJM	JH AY AH AH JH M
GIAAJN	JH AY AH AH JH N
GIAAJP	JH AY AH AH JH P
GIAAJT	JH AY AH AH JH T
GIAAJU	JH AY AE AH JH UW
GIAASC	JH AY AH AH S
GIAASM	JH AY AH AH Z AH M
GIAASN	JH AY AH AH Z N
GIAASP	JH AY AH AH S
GIAASU	JH AY AE AH S UW
GIAASY	JH AY AE AH Z IY
GIAAXM	JH AY AH AH K S M
GIAAXY	JH AY AH AE K S IY
GIAAY	JH AY AE EY IY
GIAF	JH AY AH F
GIAFN	JH AY AH F N
GIAFNG	JH AY AH F NG
GIAFNH	JH AY AH F N
GIAFO	JH AY AH F OW
GIAFU	JH AY AH F UW
GIAFY	JH AY AH F IY
GIAI	JH AY AH IY
GIAJ	JH AY AH JH
GIAJI	JH AY AH JH IY
GIAJM	JH AY AH JH M
GIAJNG	JH AY AH JH NG
GIAJT	JH AY AH JH T
GIAM	JH AY AH M
GIAN	JH IY AA N
GIANG	JH IY AA NG
GIANG(2)	JH AA NG
GIANH	JH AY AH N
GIAO	JH AY AH OW
GIAR	JH AY AH R
GIARI	JH AY AH R IY
GIARM	JH AY AH R M
GIARN	JH AY AH R N
GIARNG	JH AY AH R NG
GIARNH	JH AY AH R N
GIARO	JH AY AH R OW
GIARU	JH AY AH R UW
GIAS	JH AY AH Z
GIASC	JH AY AH S
GIASM	JH AY AH Z AH M
GIASN	JH AY AH Z N
GIASNG	JH AY AH Z NG
GIASO	JH AY AH S OW
GIASP	JH AY AH S
GIAST	JH AY AH S T
GIAU	JH AY AH UW
GIAWFM	JH AY AH W F M
GIAWFN	JH AY AH W F N
GIAWFNG	JH AY AH W F NG
GIAWJC	JH AY AH W JH K
GIAWJM	JH AY AH W JH M
GIAWJN	JH AY AH W JH N
GIAWJT	JH AY AH W JH T
GIAWM	JH AY AH W M
GIAWNG	JH AY AH W NG
GIAWST	JH AY AH W S T
GIAWXM	JH AY AH W K S M
GIAX	JH AY AH K S
GIAXI	JH AY AE K S IY
GIAXN	JH AY AH K S N
GIAXY	JH AY AE K S IY
GIEEF	JH IY AH F
GIEEFN	JH IY AH F N
GIEEFNG	JH IY AH F NG
GIEESM	JH IY AH Z AH M
GIEESNG	JH IY AH Z NG
GIEEST	JH IY AH S T
GIEEXU	JH IY EH K S UW
GIEFM	JH IY F M
GIEJO	JH IY JH OW
GIEJP	JH IY JH P
GIEO	JH IY OW
GIER	JH IH R
GIES	G IY Z
GIESO	JH IY S OW
GIEX	JH IY K S
GIF	JH IH F
GIFN	JH IH F N
GIOF	JH AY AH F
GIOFI	JH AY AH F IY
GIOFN	JH AY AH F N
GIOFNG	JH AY AH F NG
GIOJ	JH AY AH JH
GIOJC	JH AY AH JH K
GIOJI	JH AY AH JH IY
GIOJNG	JH AY AH JH NG
GIOJT	JH AY AH JH T
GIONG	JH AY AH NG
GIOOF	JH AY UW F
GIOOFI	JH AY AH F IY
GIOOFNG	JH AY UW F NG
GIOOJ	JH AY UW JH
GIOOJI	JH AY AH JH IY
GIOONG	JH AY UW NG
GIOORI	JH AY AH R IY
GIOOSC	JH AY UW S
GIOOSI	JH AY AH S IY
GIOOSNG	JH AY UW Z NG
GIOOST	JH AY UW S T
GIOOX	JH AY AH K S
GIOOXI	JH AY UH K S IY
GIOR	JH AY AH R
GIORI	JH AY AH R IY
GIORN	JH AY AH R N
GIORNG	JH AY AH R NG
GIOS	JH AY AH Z
GIOSI	JH AY AH S IY
GIOSN	JH AY AH Z N
GIOSNG	JH AY AH Z NG
GIOWF	JH AY OW F
GIOWFI	JH AY AH F IY
GIOWFN	JH AY OW F N
GIOWR	JH AY OW R
GIOWSI	JH AY AH S IY
GIOWXN	JH AY OW K S N
GIR	JH IH R
GIS	JH IH Z
GISCH	JH IH S
GIUA	JH AY UW W AH
GIUFI	JH AY AH F IY
GIUFM	JH AY AH F M
GIUJA	JH AY UW JH AH
GIUJC	JH AY AH JH K
GIUJI	JH AY AH JH IY
GIUN	JH IY AH N
GIUOOJC	JH AY AH W UW JH K
GIURI	JH AY AH R IY
GIUS	JH AY AH S
GIUSI	JH AY AH S IY
GIUSP	JH AY AH S
GIUWF	JH AY AH W F
GIUWJT	JH AY AH W JH T
GIUWOWFNG	JH AY AH W OW F NG
GIUWOWNG	JH AY AH W OW NG
GIUWOWSNG	JH AY AH W OW S NG
GIUWX	JH AY AH W K S
GIUWXA	JH AY AH W K S AH
GIUX	JH IY AH K S
GIUXA	JH AY AH K S AH
GO	G OW
GOF	G AA F
GOFN	G AA F N
GOJ	G AA JH
GOJI	G OW JH IY
GOJN	G AA JH N
GOJNG	G AA JH NG
GOJT	G AA JH T
GOM	G AA M
GON	G AA N
GOO	G UW
GOOF	G UW F
GOOFI	G UW F IY
GOOFM	G UW F M
GOOFNG	G UW F NG
GOOJC	G UW JH K
GOOJI	G UW JH IY
GOOJP	G UW JH P
GOOJT	G UW JH T
GOOM	G UW M
GOON	G UW N
GOONG	G UW NG
GOOR	G OW ER
GOOSC	G UW S
GOOSI	G UW S IY
GOOSM	G UW Z AH M
GOOX	G OW AA K S
GORI	G AO R IY
GORNG	G AO R NG
GOSA	G OW S AH
GOSC	G AA S
GOSI	G OW S IY
GOSP	G AA S
GOST	G AA S T
GOW	G AW
GOWF	G OW F
GOWFM	G OW F M
GOWFN	G OW F N
GOWJI	G OW JH IY
GOWJN	G OW JH N
GOWJT	G OW JH T
GOWN	G AW N
GOWR	G OW R
GOWRI	G OW R IY
GOWSM	G OW Z AH M
GOWX	G OW K S
GOX	G AA K S
GU	G UW
GUF	G AH F
GUFI	G Y UW F IY
GUFN	G AH F N
GUFNG	G AH F NG
GUJ	G AH JH
GUJC	G AH JH K
GUJI	G Y UW JH IY
GUOOFNG	G Y UW UW F NG
GUOOJC	G Y UW UW JH K
GUOOJT	G Y UW UW JH T
GUOOSC	G Y UW UW S
GUST	G AH S T
GUWF	G AH W F
GUWFNG	G AH W F NG
GUWOWFM	G AH W OW F M
GUWOWFNG	G AH W OW F NG
GUWOWJM	G AH W OW JH M
GUWOWJNG	G AH W OW JH NG
GUWOWM	G AH W OW M
GUWOWNG	G AH W OW NG
GUWOWXNG	G AH W OW K S NG
GUWRI	G AH W R IY
GUWSNG	G AH W S NG
GUXI	G AH K S IY
HA	HH AA
HAAFM	HH AA F M
HAAFU	HH AA F UW
HAAFY	HH AA F IY
HAAJN	HH AA JH N
HAAJU	HH AA JH UW
HAAM	HH AA M
HAAN	HH AA N
HAARM	HH AA R M
HAARU	HH AA R UW
HAARY	HH EY AH R IY
HAASN	HH AA Z N
HAASP	HH AA S
HAAST	HH AA S T
HAASU	HH AA S UW
HAAU	HH AA UW
HAAXNG	HH AA K S NG
HAF	HH AE F
HAFI	HH AE F IY
HAFM	HH AE F M
HAFN	HH AE F N
HAFNG	HH AE F NG
HAFNH	HH AE F N
HAFO	HH AE F OW
HAFU	HH AE F UW
HAI	HH EY
HAJ	HH AE JH
HAJC	HH AE JH K
HAJCH	HH AE JH CH
HAJI	HH AE JH IY
HAJM	HH AE JH M
HAJN	HH AE JH N
HAJNG	HH AE JH NG
HAJNH	HH AE JH N
HAJO	HH AE JH OW
HAJP	HH AE JH P
HAJT	HH AE JH T
HAJY	HH EY JH IY
HAM	HH AE M
HAN	HH AA N
HAN(2)	HH AE N
HANG	HH AE NG
HANH	HH AE N
HAO	HH AW
HAR	HH AA R
HARI	HH AA R IY
HARNG	HH AA R NG
HARO	HH AA R OW
HAS	HH AE Z
HAS(2)	HH AH Z
HASC	HH AE S
HASCH	HH AE SH
HASI	HH AE S IY
HASM	HH AE Z AH M
HASN	HH AE Z N
HASNG	HH AE Z NG
HASO	HH AA S OW
HASP	HH AE S P
HAST	HH AE S T
HASY	HH AA Z IY
HAWFM	HH AO F M
HAWFN	HH AO F N
HAWFNG	HH AO F NG
HAWJC	HH AO JH K
HAWM	HH AO M
HAWNG	HH AO NG
HAWRN	HH AO R N
HAWSC	HH AO S
HAWSN	HH AO S N
HAWSNG	HH AO S NG
HAWST	HH AO S T
HAXI	HH AE K S IY
HAXM	HH AE K S M
HAXN	HH AE K S N
HAXNG	HH AE K S NG
HAXNH	HH AE K S N
HAXO	HH AE K S OW
HAXY	HH AE K S IY
HAY	HH EY
HE	HH IY
HEE	HH IY
HEEF	HH IY F
HEEJ	HH IY JH
HEEJCH	HH IY JH CH
HEEJT	HH IY JH T
HEEN	HH IY AH N
HEENH	HH IY N
HEER	HH IY ER
HEERN	HH IH R N
HEERNH	HH IH R N
HEESCH	HH IY SH
HEESN	HH IY Z N
HEEST	HH IY AH S T
HEESU	HH IY S UW
HEEX	HH IY K S
HEF	HH EH F
HEFM	HH EH F M
HEFN	HH EH F N
HEFO	HH EH F OW
HEJ	HH EH JH
HEJN	HH EH JH N
HEJP	HH EH JH P
HEJT	HH EH JH T
HEM	HH EH M
HEN	HH EH N
HEO	HH IY OW
HERM	HH ER M
HERO	HH IH R OW
HERO(2)	HH IY R OW
HES	HH IY Z
HESC	HH EH S
HESO	HH EH S OW
HEST	HH EH S T
HI	HH AY
HIA	HH AY AH
HIEEFM	HH IY AH F M
HIEEFN	HH IY AH F N
HIEEJN	HH IY AH JH N
HIEEJP	HH IY AH JH P
HIEEJU	HH IY AH JH UW
HIEEN	HH IY AH N
HIEERM	HH IY AH R M
HIEERN	HH IY AH R N
HIEERU	HH IY AH R UW
HIEESM	HH IY AH Z AH M
HIEESN	HH IY AH Z N
HIEESNG	HH IY AH Z NG
HIEESP	HH IY AH S
HIEESU	HH IY AH S UW
HIFNH	HH IH F N
HIJCH	HH IH JH CH
HIN	HH IH N
HIR	HH IH R
HIRNH	HH AH R N
HIS	HH IH Z
HISCH	HH IH S
HISP	HH IH S
HIST	HH IH S T
HIU	HH AY UW
HIX	HH IH K S
HIXNH	HH IH K S N
HO	HH OW
HOA	HH OW AH
HOAF	HH OW F
HOAFI	HH OW F IY
HOAFN	HH OW F N
HOAFNG	HH OW F NG
HOAFNH	HH OW F N
HOAJ	HH OW JH
HOAJCH	HH OW JH CH
HOAJI	HH OW JH IY
HOAJN	HH OW JH N
HOAJNH	HH OW JH N
HOAJT	HH OW JH T
HOAN	HH OW AH N
HOANG	HH OW NG
HOAR	HH AO R
HOARNG	HH OW R NG
HOARNH	HH OW R N
HOAS	HH OW Z
HOASC	HH OW S
HOASN	HH OW Z N
HOASNH	HH OW Z N
HOASY	HH OW Z IY
HOAWFNG	HH OW W F NG
HOAWJC	HH OW W JH K
HOAWNG	HH OW W NG
HOAWSC	HH OW W S
HOAWSM	HH OW W Z AH M
HOAWST	HH OW W S T
HOAWXNG	HH OW W K S NG
HOAXN	HH OW K S N
HOAY	HH OW IY
HOE	HH OW
HOEF	HH OW AH F
HOEJ	HH OW AH JH
HOEJT	HH OW AH JH T
HOEN	HH OW N
HOERN	HH AH R N
HOEST	HH OW AH S T
HOF	HH AA F
HOFM	HH AA F M
HOFN	HH AA F N
HOFNG	HH AA F NG
HOI	HH OY
HOJ	HH AA JH
HOJC	HH AA JH K
HOJNG	HH AA JH NG
HOJP	HH AA JH P
HOM	HH AA M
HON	HH AA N
HONG	HH AO NG
HOO	HH UW
HOOF	HH UW F
HOOFI	HH UW F IY
HOOFM	HH UW F M
HOOFN	HH UW F N
HOOFNG	HH UW F NG
HOOI	HH UW IY
HOOJ	HH UW JH
HOOJC	HH UW JH K
HOOJI	HH UW JH IY
HOOJN	HH UW JH N
HOOJP	HH UW JH P
HOOJT	HH UW JH T
HOOM	HH UW M
HOON	HH UW N
HOONG	HH UW NG
HOOR	HH OW ER
HOORI	HH UH R IY
HOORN	HH UH R N
HOORNG	HH UH R NG
HOOS	HH UW Z
HOOSC	HH UW S
HOOSI	HH UW S IY
HOOSNG	HH UW Z NG
HOOST	HH UW S T
HOOX	HH UH K S
HOOXM	HH UH K S M
HOOXN	HH UH K S N
HORI	HH AO R IY
HORM	HH AO R M
HORN	HH AO R N
HORNG	HH AO R NG
HOSC	HH AA S
HOSI	HH OW S IY
HOSM	HH AA Z AH M
HOSNG	HH AA Z NG
HOSP	HH AA S
HOST	HH OW S T
HOW	HH AW
HOWF	HH OW F
HOWFI	HH OW F IY
HOWFN	HH OW F N
HOWI	HH OW IY
HOWJI	HH OW JH IY
HOWJM	HH OW JH M
HOWJP	HH OW JH P
HOWJT	HH OW JH T
HOWN	HH OW N
HOWR	HH OW R
HOWRI	HH OW R IY
HOWS	HH AW Z
HOWSN	HH OW S N
HOWSP	HH OW S
HOWST	HH OW S T
HOWXI	HH OW K S IY
HOXM	HH AA K S M
HU	HH UW
HUA	HH UW AH
HUA(2)	HH W AA
HUAAN	HH Y UW EY AH N
HUAASN	HH Y UW AH Z N
HUEE	HH Y UW IY
HUEEF	HH Y UW AH AH F
HUEEJ	HH Y UW AH AH JH
HUEENH	HH Y UW AH AH N
HUEES	HH Y UW IY Z
HUEESCH	HH Y UW AH AH S
HUF	HH AH F
HUFA	HH Y UW F AH
HUFM	HH AH F M
HUFN	HH AH F N
HUFNG	HH AH F NG
HUJ	HH AH JH
HUJC	HH AH JH K
HUJI	HH Y UW JH IY
HUJM	HH AH JH M
HUJP	HH AH JH P
HUJT	HH AH JH T
HUM	HH AH M
HUN	HH AH N
HUNG	HH AH NG
HUOOSNG	HH Y UW UW Z NG
HUOW	HH Y UW OW
HUOWXN	HH Y UW OW K S N
HUR	HH ER
HURI	HH Y UH R IY
HURN	HH ER N
HUS	HH AH Z
HUSC	HH AH S
HUSI	HH Y UW S IY
HUSNG	HH AH Z NG
HUSP	HH AH S
HUST	HH AH S T
HUSY	HH Y UW Z IY
HUW	HH AH W
HUWF	HH AH W F
HUWFA	HH AH W F AH
HUWFNG	HH AH W F NG
HUWJC	HH AH W JH K
HUWJU	HH AH W JH UW
HUWNG	HH AH W NG
HUWOWFNG	HH AH W OW F NG
HUWOWJM	HH AH W OW JH M
HUWOWNG	HH AH W OW NG
HUWOWRNG	HH AH W OW R NG
HUWOWSC	HH AH W OW S
HUWOWSNG	HH AH W OW S NG
HUWOWU	HH AH W OW UW
HUWR	HH AH W R
HUWRNG	HH AH W R NG
HUWS	HH AH W Z
HUWSA	HH AH W S AH
HUWSC	HH AH W S
HUWSNG	HH AH W S NG
HUWU	HH AH W UW
HUWXNG	HH AH W K S NG
HUWXU	HH AH W K S UW
HUX	HH AH K S
HUXM	HH AH K S M
HUY	HH Y UW IY
HUYEEFN	HH Y UW AY IY F N
HUYEEJN	HH Y UW AY IY JH N
HUYEEJT	HH Y UW AY IY JH T
HUYEEN	HH Y UW AY IY AH N
HUYEEST	HH Y UW AY IY AH S T
HUYEEXN	HH Y UW AY IY K S N
HUYFNH	HH Y UW AH F N
HUYJCH	HH Y UW AH JH CH
HUYNH	HH AY N
HUYR	HH Y UW AH R
HUYSCH	HH Y UW AH S
HUYST	HH Y UW AH S T
HY	HH AY
HYR	HH IH R
IFN	IH F N
IFNH	IH F N
IJCH	IH JH CH
IJN	IH JH N
IJT	IH JH T
IM	IH M
IN	IH N
INH	IH N
IRA	AY R AH
IRA(2)	AY AA R EY
IRM	AH R M
IRN	AH R N
IRU	IH R UW
ISCH	IH SH
ISN	IH Z N
IST	IH S T
IXNH	IH K S N
KA	K AA
KAN	K AE N
KAY	K EY
KE	K EH
KEE	K IY
KEEF	K IY F
KEEFM	K IY F M
KEEFN	K IY F N
KEEFNH	K IY F N
KEEFU	K IY F UW
KEEJ	K IY JH
KEEJCH	K IY JH CH
KEEJNH	K IY JH N
KEEN	K IY N
KEENG	K IY NG
KEENH	K IY N
KEER	K IY AH R
KEES	K IY Z
KEESCH	K IY S
KEESP	K IY S
KEEST	K IY AH S T
KEEU	K IY UW
KEEXNH	K IY K S N
KEF	K EH F
KEFM	K EH F M
KEFN	K EH F N
KEFO	K EH F OW
KEJ	K EH JH
KEJO	K EH JH OW
KEJP	K EH JH P
KEJT	K EH JH T
KEM	K EH M
KEN	K EH N
KENG	K EH NG
KEO	K IY OW
KER	K ER
KERNG	K AH R NG
KERO	K EH R OW
KES	K S
KESC	K EH S
KESM	K EH Z AH M
KESN	K EH Z N
KESO	K EH S OW
KESP	K EH S
KEST	K EH S T
KEX	K EH K S
KEXM	K EH K S M
KEXO	K EH K S OW
KHA	K HH AA
KHAAJP	K HH AA JH P
KHAAM	K HH AA M
KHAAN	K HH EY AH N
KHAARN	K HH AA R N
KHAARU	K HH AA R UW
KHAARY	K HH EY AH R IY
KHAASC	K HH AA S
KHAASN	K HH AA Z N
KHAASP	K HH AA S
KHAAST	K HH AA S T
KHAASU	K HH AA S UW
KHAAU	K HH AA UW
KHAF	K HH AE F
KHAFN	K HH AE F N
KHAI	K HH EY
KHAJ	K HH AE JH
KHAJC	K HH AE JH K
KHAJNG	K HH AE JH NG
KHAJO	K HH AE JH OW
KHAJP	K HH AE JH P
KHAM	K HH AE M
KHAN	K AA N
KHANG	K HH AE NG
KHANH	K HH AE N
KHAO	K HH EY OW
KHAR	K HH AA R
KHARI	K HH AE R IY
KHARM	K HH AA R M
KHARN	K HH AA R N
KHARNG	K HH AA R NG
KHARNH	K HH AA R N
KHARO	K HH AE R OW
KHAS	K HH AE Z
KHASC	K HH AE S
KHASCH	K HH AE S
KHASI	K HH AE S IY
KHASM	K HH AE Z AH M
KHASN	K HH AE Z N
KHASNG	K HH AE Z NG
KHASNH	K HH AE Z N
KHASO	K HH AE S OW
KHASP	K HH AE S
KHAST	K HH AE S T
KHASU	K HH AE S UW
KHASY	K HH EY Z IY
KHAU	K HH AO
KHAWJC	K HH AO JH K
KHAWM	K HH AO M
KHAWN	K HH AO N
KHAWNG	K HH AO NG
KHAWRM	K HH AO R M
KHAWRN	K HH AO R N
KHAWRNG	K HH AO R NG
KHAWSC	K HH AO S
KHAWSM	K HH AO Z AH M
KHAWSN	K HH AO S N
KHAWSP	K HH AO S
KHAWST	K HH AO S T
KHAY	K HH EY IY
KHE	K EY
KHEE	K HH IY
KHEEF	K HH IY F
KHEEFU	K HH IY F UW
KHEEJ	K HH IY JH
KHEEJNH	K HH IY JH N
KHEENH	K HH IY N
KHEERNH	K HH IH R N
KHEES	K HH IY Z
KHEEU	K HH IY UW
KHEF	K HH EH F
KHEFN	K HH EH F N
KHEFO	K HH EH F OW
KHEJC	K HH EH JH K
KHEM	K EH M
KHEN	K HH EH N
KHEO	K HH IY OW
KHES	K HH S
KHESO	K HH EH S OW
KHESP	K HH EH S
KHEST	K HH EH S T
KHEX	K HH EH K S
KHI	K HH IY
KHIEEFN	K HH IY AH F N
KHIEEM	K HH IY AH M
KHIEEN	K HH IY AH N
KHIEENG	K HH IY AH NG
KHIEERN	K HH IY AH R N
KHIEESM	K HH IY AH Z AH M
KHIEESN	K HH IY AH Z N
KHIEESP	K HH IY AH S
KHIEEST	K HH IY AH S T
KHIEESU	K HH IY AH S UW
KHIEEU	K HH IY UW
KHIEEXNG	K HH IY AH K S NG
KHIF	K HH IH F
KHIFN	K HH IH F N
KHIJA	K HH IH JH AH
KHIJT	K HH IH JH T
KHIN	K HH IH N
KHINH	K HH IH N
KHIR	K HH IH R
KHIRNH	K HH AH R N
KHIS	K HH IH Z
KHISA	K HH IH S AH
KHISCH	K HH IH S
KHIST	K HH IH S T
KHISU	K HH IH S UW
KHIU	K HH AY UW
KHIXNH	K HH IH K S N
KHO	K HH OW
KHOA	K HH OW AH
KHOAI	K HH OW IY
KHOAN	K HH OW AH N
KHOANG	K HH OW NG
KHOANH	K HH OW N
KHOARI	K HH OW R IY
KHOARN	K HH OW R N
KHOARNG	K HH OW R NG
KHOARNH	K HH OW R N
KHOAS	K HH OW Z
KHOASC	K HH OW S
KHOASI	K HH OW S IY
KHOASN	K HH OW Z N
KHOASNG	K HH OW Z NG
KHOAST	K HH OW S T
KHOASY	K HH OW Z IY
KHOAWFM	K HH OW W F M
KHOAWM	K HH OW W M
KHOAWN	K HH OW W N
KHOAWSN	K HH OW W S N
KHOAWSNG	K HH OW W S NG
KHOAWST	K HH OW W S T
KHOE	K HH OW
KHOEFO	K HH OW AH F OW
KHOEO	K HH OW AH OW
KHOER	K HH OW AH R
KHOES	K HH OW Z
KHOEST	K HH OW AH S T
KHOF	K HH AA F
KHOFM	K HH AA F M
KHOI	K HH OY
KHOJM	K HH AA JH M
KHOM	K HH AA M
KHOO	K UW
KHOOI	K HH UW IY
KHOON	K HH UW N
KHOONG	K HH UW NG
KHOOOOSNG	K HH UW UW Z NG
KHOOR	K HH OW AH R
KHOORN	K HH UH R N
KHOORNG	K HH UH R NG
KHOOS	K HH UW Z
KHOOSC	K HH UW S
KHOOSI	K HH UW S IY
KHOOSN	K HH UW Z N
KHOOSNG	K HH UW Z NG
KHORA	K HH AO R AH
KHORI	K HH AO R IY
KHORNG	K HH AO R NG
KHOS	K HH AA Z
KHOSC	K HH AA S
KHOSI	K HH AA S IY
KHOSM	K HH AA Z AH M
KHOW	K HH OW
KHOWF	K HH OW F
KHOWI	K HH OW IY
KHOWRI	K HH OW R IY
KHOWS	K HH OW Z
KHOWSP	K HH OW S
KHU	K HH UW
KHUA	K HH Y UW AH
KHUAAN	K HH Y UW EY AH N
KHUAANG	K HH Y UW AH NG
KHUAARN	K HH Y UW AH R N
KHUAAST	K HH Y UW AH S T
KHUAASY	K HH Y UW AH Z IY
KHUAAY	K HH Y UW AH IY
KHUEE	K HH Y UW IY IY
KHUEESCH	K HH Y UW AH AH S
KHUF	K HH AH F
KHUFA	K HH Y UW F AH
KHUFNG	K HH AH F NG
KHUI	K HH UW
KHUJ	K HH AH JH
KHUJC	K HH AH JH K
KHUJT	K HH AH JH T
KHUM	K HH AH M
KHUNG	K HH AH NG
KHUOON	K HH Y UW UW N
KHUOONG	K HH Y UW UW NG
KHUR	K HH AH R
KHURA	K HH Y UH R AH
KHURNG	K HH AH R NG
KHUS	K HH AH Z
KHUSC	K HH AH S
KHUSM	K HH AH Z AH M
KHUW	K HH AH W
KHUWF	K HH AH W F
KHUWFA	K HH AH W F AH
KHUWFNG	K HH AH W F NG
KHUWJA	K HH AH W JH AH
KHUWOWN	K HH AH W OW N
KHUWOWNG	K HH AH W OW NG
KHUWOWSC	K HH AH W OW S
KHUWOWST	K HH AH W OW S T
KHUWOWSU	K HH AH W OW S UW
KHUWR	K HH AH W R
KHUWS	K HH AH W Z
KHUWSA	K HH AH W S AH
KHUWSNG	K HH AH W S NG
KHUWSU	K HH AH W S UW
KHUY	K HH Y UW IY
KHUYA	K HH Y UW AY AH
KHUYEEN	K HH Y UW AY IY AH N
KHUYEERN	K HH Y UW AY AH R N
KHUYEESN	K HH Y UW AY IY Z N
KHUYEEST	K HH Y UW AY IY AH S T
KHUYFNH	K HH Y UW AH F N
KHUYJU	K HH Y UW AH JH UW
KHUYNH	K HH Y UW AH N
KHUYRU	K HH Y UW AH R UW
KI	K IY
KIA	K IY ER
KIEEFM	K IY AH F M
KIEEFN	K IY AH F N
KIEEFNG	K IY AH F NG
KIEEFU	K IY AH F UW
KIEEJM	K IY AH JH M
KIEEJN	K IY AH JH N
KIEEJT	K IY AH JH T
KIEEJU	K IY AH JH UW
KIEEM	K IY AH M
KIEEN	K IY AH N
KIEENG	K IY AH NG
KIEERM	K IY AH R M
KIEERNG	K IY AH R NG
KIEERU	K IY AH R UW
KIEESM	K IY AH Z AH M
KIEESN	K IY AH Z N
KIEESP	K IY AH S
KIEEST	K IY AH S T
KIEESU	K IY AH S UW
KIEEU	K IY UW
KIEEXNG	K IY AH K S NG
KIF	K IH F
KIFA	K IH F AH
KIFM	K IH F M
KIFN	K IH F N
KIFNH	K IH F N
KIJ	K IH JH
KIJCH	K IH JH CH
KIJP	K IH JH P
KIJT	K IH JH T
KIM	K IH M
KINH	K IH N
KIR	K IH R
KIRNH	K AH R N
KIS	K IH S
KISCH	K IH SH
KISN	K IH Z N
KISNH	K IH Z N
KISP	K IH S
KIXU	K IH K S UW
KOST	K AA S T
KOWI	K OW IY
KU	K UW
KUEENH	K Y UW AH AH N
KUNG	K AH NG
KY	K AY
KYF	K IH F
KYJ	K IH JH
KYR	K IH R
KYS	K IH Z
KYX	K IH K S
LA	L AA
LAAFM	L AA F M
LAAFN	L AA F N
LAAFU	L AA F UW
LAAFY	L AA F IY
LAAJN	L AA JH N
LAAJP	L AA JH P
LAAJT	L AA JH T
LAAJU	L AA JH UW
LAAM	L AA M
LAAN	L EY AH N
LAANG	L AA NG
LAARM	L AA R M
LAARN	L AA R N
LAARY	L EY AH R IY
LAASC	L AA S
LAASM	L AA Z AH M
LAASN	L AA Z N
LAASP	L AA S
LAAST	L AA S T
LAASY	L AA Z IY
LAAU	L AA UW
LAAXM	L AA K S M
LAAXN	L AA K S N
LAAXY	L AA K S IY
LAAY	L AA IY
LAF	L AE F
LAFI	L AE F IY
LAFM	L AE F M
LAFN	L AE F N
LAFNG	L AE F NG
LAFNH	L AE F N
LAFO	L AE F OW
LAFU	L AE F UW
LAI	L AY
LAJ	L AE JH
LAJC	L AE JH K
LAJCH	L AE JH CH
LAJI	L AE JH IY
LAJM	L AE JH M
LAJN	L AE JH N
LAJNG	L AE JH NG
LAJNH	L AE JH N
LAJO	L AE JH OW
LAJP	L AE JH P
LAJT	L AE JH T
LAJY	L EY JH IY
LAM	L AE M
LAN	L AE N
LANG	L AE NG
LANH	L AE N
LAO	L AW
LAR	L AA R
LARI	L AE R IY
LARM	L AA R M
LARNG	L AA R NG
LARNH	L AA R N
LARO	L AE R OW
LARU	L AE R UW
LARY	L EH R IY
LAS	L AA S
LAS(2)	EH L EY EH S
LASC	L AE S
LASCH	L AE SH
LASI	L AE S IY
LASN	L AE Z N
LASNG	L AE Z NG
LASNH	L AE Z N
LASO	L AE S OW
LASP	L AE S
LAST	L AE S T
LASU	L AE S UW
LASY	L AA Z IY
LAU	L AW
LAWFN	L AO F N
LAWFNG	L AO F NG
LAWJC	L AO JH K
LAWJM	L AO JH M
LAWJN	L AO JH N
LAWJNG	L AO JH NG
LAWJP	L AO JH P
LAWJT	L AO JH T
LAWM	L AO M
LAWN	L AO N
LAWNG	L AO NG
LAWRM	L AO R M
LAWRN	L AO R N
LAWRNG	L AO R NG
LAWSC	L AO S
LAWSM	L AO Z AH M
LAWSNG	L AO S NG
LAWSP	L AO S
LAWST	L AO S T
LAWXNG	L AO K S NG
LAX	L AE K S
LAXI	L AE K S IY
LAXM	L AE K S M
LAXN	L AE K S N
LAXNG	L AE K S NG
LAXNH	L AE K S N
LAXO	L AE K S OW
LAY	L EY
LE	L AH
LEE	L IY
LEEF	L IY F
LEEFNH	L IY F N
LEEFU	L IY F UW
LEEJ	L IY JH
LEEJCH	L IY JH CH
LEEJNH	L IY JH N
LEEJT	L IY JH T
LEEN	L IY N
LEENH	L IY N
LEER	L IH ER
LEERU	L IH R UW
LEESCH	L IY S
LEEST	L IY AH S T
LEESU	L IY S UW
LEEU	L IY UW
LEEX	L IY K S
LEEXU	L IY K S UW
LEF	L EH F
LEFM	L EH F M
LEFN	L EH F N
LEFNG	L EH F NG
LEFO	L EH F OW
LEJ	L EH JH
LEJM	L EH JH M
LEJN	L EH JH N
LEJO	L EH JH OW
LEJP	L EH JH P
LEJT	L EH JH T
LEM	L EH M
LEN	L EH N
LENG	L EH NG
LEO	L IY OW
LER	L EH R
LERN	L AH R N
LERNG	L AH R NG
LERO	L EH R OW
LES	L EH S
LES(2)	L EY
LESM	L EH Z AH M
LESN	L EH Z N
LESNG	L EH Z NG
LESO	L EH S OW
LESP	L EH S
LEST	L EH S T
LEX	L EH K S
LEXN	L EH K S N
LEXO	L EH K S OW
LI	L IY
LIA	L IY AH
LIEEFM	L IY AH F M
LIEEFN	L IY AH F N
LIEEFNG	L IY AH F NG
LIEEFU	L IY AH F UW
LIEEJM	L IY AH JH M
LIEEJNG	L IY AH JH NG
LIEEJP	L IY AH JH P
LIEEJT	L IY AH JH T
LIEEJU	L IY AH JH UW
LIEEM	L IY AH M
LIEEN	L AY AH N
LIEENG	L IY AH NG
LIEERNG	L IY AH R NG
LIEESC	L IY AH S
LIEESM	L IY AH Z AH M
LIEESN	L IY AH Z N
LIEESP	L IY AH S
LIEESU	L IY AH S UW
LIEEU	L IY UW
LIEEXM	L IY AH K S M
LIEEXN	L IY AH K S N
LIEEXU	L IY EH K S UW
LIF	L IH F
LIFA	L IH F AH
LIFM	L IH F M
LIFN	L IH F N
LIFNH	L IH F N
LIFU	L IH F UW
LIJ	L IH JH
LIJA	L IH JH AH
LIJCH	L IH JH CH
LIJM	L IH JH M
LIJNH	L IH JH N
LIJU	L IH JH UW
LIM	L IH M
LIN	L IH N
LINH	L IH N
LIRNH	L AH R N
LIS	L IH S
LISCH	L IH S
LISNH	L IH Z N
LISP	L IH S P
LIST	L IH S T
LISU	L IH S UW
LIU	L Y UW
LIXNH	L IH K S N
LO	L OW
LOA	L OW AH
LOAF	L OW F
LOAFI	L OW F IY
LOAFN	L OW F N
LOAFNG	L OW F NG
LOAI	L OW IY
LOAJC	L OW JH K
LOAJI	L OW JH IY
LOAJN	L OW JH N
LOAJNG	L OW JH NG
LOAJT	L OW JH T
LOAN	L OW N
LOANG	L OW NG
LOANH	L OW N
LOARNG	L OW R NG
LOASN	L OW Z N
LOASNG	L OW Z NG
LOAST	L OW S T
LOAWFNG	L OW W F NG
LOAWN	L OW W N
LOAWNG	L OW W NG
LOAWST	L OW W S T
LOAXNG	L OW K S NG
LOAY	L OW IY
LOE	L OW
LOEF	L OW AH F
LOEJT	L OW AH JH T
LOEST	L OW AH S T
LOF	L AA F
LOFI	L OW F IY
LOFM	L AA F M
LOFN	L AA F N
LOFNG	L AA F NG
LOI	L OY
LOJ	L AA JH
LOJC	L AA JH K
LOJI	L OW JH IY
LOJM	L AA JH M
LOJN	L AA JH N
LOJNG	L AA JH NG
LOJT	L AA JH T
LOM	L AA M
LON	L AA N
LONG	L AO NG
LOO	L UW
LOOF	L UW F
LOOFI	L UW F IY
LOOFM	L UW F M
LOOFN	L UW F N
LOOFNG	L UW F NG
LOOI	L UW IY
LOOJ	L UW JH
LOOJC	L UW JH K
LOOJI	L UW JH IY
LOOJM	L UW JH M
LOOJN	L UW JH N
LOOJNG	L UW JH NG
LOOJP	L UW JH P
LOOJT	L UW JH T
LOOM	L UW M
LOON	L UW N
LOONG	L UH NG
LOOR	L OW AH R
LOORM	L UH R M
LOORN	L UH R N
LOORNG	L UH R NG
LOOS	L UW Z
LOOSC	L UW S
LOOSI	L UW S IY
LOOSM	L UW Z AH M
LOOSN	L UW Z N
LOOSP	L UW S
LOOST	L UW S T
LOOX	L UH K S
LOOXI	L UH K S IY
LORA	L AO R AH
LORI	L AO R IY
LORM	L AO R M
LORN	L AO R N
LORNG	L AO R NG
LOS	L OW S
LOS(2)	L AO S
LOSA	L OW S AH
LOSC	L AA S
LOSE	L UW Z
LOSI	L OW S IY
LOSM	L AA Z AH M
LOSNG	L AA Z NG
LOSP	L AA S
LOST	L AO S T
LOW	L OW
LOWF	L OW F
LOWFI	L OW F IY
LOWFM	L OW F M
LOWFN	L OW F N
LOWI	L OW IY
LOWJ	L OW JH
LOWJI	L OW JH IY
LOWJM	L OW JH M
LOWJN	L OW JH N
LOWJP	L OW JH P
LOWJT	L OW JH T
LOWN	L AW N
LOWNG	L OW NG
LOWR	L OW R
LOWRM	L OW R M
LOWRN	L OW R N
LOWS	L OW Z
LOWSI	L OW S IY
LOWSN	L OW S N
LOWSP	L OW S
LOWST	L OW S T
LOWX	L OW K S
LOWXI	L OW K S IY
LOWXM	L OW K S M
LOX	L AA K S
LOX(2)	L AH K S
LOXA	L AA K S AH
LOXI	L AA K S IY
LOXM	L AA K S M
LOXNG	L AA K S NG
LU	L UW
LUAAJN	L UW W AH JH N
LUAAJT	L UW W AH JH T
LUAAN	L UW W EY AH N
LUAARN	L UW W AH R N
LUAASN	L UW W AH Z N
LUF	L AH F
LUFA	L UW F AH
LUFI	L UW F IY
LUFM	L AH F M
LUFN	L AH F N
LUFNG	L AH F NG
LUI	L UW IH
LUJ	L AH JH
LUJA	L UW JH AH
LUJC	L AH JH K
LUJI	L UW JH IY
LUJN	L AH JH N
LUJNG	L AH JH NG
LUJP	L AH JH P
LUJT	L AH JH T
LUM	L AH M
LUNG	L AH NG
LUOOFN	L UW W UW F N
LUOOFNG	L UW W UW F NG
LUOOJC	L UW W UW JH K
LUOOJM	L UW W UW JH M
LUOOM	L UW W UW M
LUOON	L UW W UW N
LUOONG	L UW W UW NG
LUOOSC	L UW W UW S
LUOOSNG	L UW W UW Z NG
LUOOXNG	L UW W AH K S NG
LUR	L AH R
LURI	L UH R IY
LURM	L AH R M
LURN	L AH R N
LURNG	L AH R NG
LUS	L AH Z
LUSA	L UW S AH
LUSC	L AH S
LUSI	L UW S IY
LUSM	L AH Z AH M
LUSN	L AH Z N
LUSNG	L AH Z NG
LUSP	L AH S
LUST	L AH S T
LUW	L AH W
LUWA	L AH W AH
LUWF	L AH W F
LUWFA	L AH W F AH
LUWFNG	L AH W F NG
LUWJ	L AH W JH
LUWJA	L AH W JH AH
LUWJC	L AH W JH K
LUWJNG	L AH W JH NG
LUWJU	L AH W JH UW
LUWNG	L AH W NG
LUWOWFI	L AH W OW F IY
LUWOWFM	L AH W OW F M
LUWOWFN	L AH W OW F N
LUWOWFNG	L AH W OW F NG
LUWOWJC	L AH W OW JH K
LUWOWJM	L AH W OW JH M
LUWOWJN	L AH W OW JH N
LUWOWJNG	L AH W OW JH NG
LUWOWJT	L AH W OW JH T
LUWOWM	L AH W OW M
LUWOWN	L AH W OW N
LUWOWNG	L AH W OW NG
LUWOWSI	L AH W OW S IY
LUWOWST	L AH W OW S T
LUWOWXI	L AH W OW K S IY
LUWOWXNG	L AH W OW K S NG
LUWR	L AH W R
LUWRA	L AH W R AH
LUWRNG	L AH W R NG
LUWSA	L AH W S AH
LUWSC	L AH W S
LUWU	L AH W UW
LUWX	L AH W K S
LUWXA	L AH W K S AH
LUWXNG	L AH W K S NG
LUX	L AH K S
LUXA	L AH K S AH
LUXM	L AH K S M
LUXN	L AH K S N
LUXNG	L AH K S NG
LUXY	L AH K S IY
LUYEEJN	L UW W AY IY JH N
LUYEESN	L UW W AY IY Z N
LUYJ	L UW W AH JH
LUYS	L UW W AH Z
LUYX	L UW W AH K S
LY	L AY
LYJ	L IH JH
LYS	L IH Z
LYX	L IH K S
MA	M AA
MAAFM	M AA F M
MAAFN	M AA F N
MAAFNG	M AA F NG
MAAFU	M AA F UW
MAAJN	M AA JH N
MAAJP	M AA JH P
MAAJT	M AA JH T
MAAJU	M AA JH UW
MAAM	M AH M
MAAN	M EY AH N
MAANG	M AA NG
MAARM	M AA R M
MAARN	M AA R N
MAARU	M AA R UW
MAARY	M EY AH R IY
MAASM	M AA Z AH M
MAASN	M AA Z N
MAASP	M AA S
MAAST	M AA S T
MAASU	M AA S UW
MAASY	M AA Z IY
MAAU	M AA UW
MAAXM	M AA K S M
MAAXN	M AA K S N
MAAXU	M AA K S UW
MAAY	M AA IY
MAF	M AE F
MAFI	M AE F IY
MAFN	M AE F N
MAFNG	M AE F NG
MAFNH	M AE F N
MAFO	M AE F OW
MAFU	M AE F UW
MAFY	M EY F IY
MAI	M AY
MAJ	M AE JH
MAJC	M AE JH K
MAJCH	M AE JH CH
MAJI	M AE JH IY
MAJN	M AE JH N
MAJNG	M AE JH NG
MAJNH	M AE JH N
MAJO	M AE JH OW
MAJP	M AE JH P
MAJT	M AE JH T
MAJY	M EY JH IY
MAN	M AE N
MANG	M AE NG
MANH	M AE N
MAO	M AW
MAR	M AA R
MARI	M AA R IY
MARNG	M AA R NG
MARNH	M AA R N
MARY	M EH R IY
MAS	M AA Z
MASC	M AE S
MASCH	M AE SH
MASI	M AA S IY
MASN	M AE Z N
MASNG	M AE Z NG
MASNH	M AE Z N
MASO	M AE Z OW
MAST	M AE S T
MASU	M AE S UW
MASY	M AA Z IY
MAU	M OW
MAU(2)	M AW
MAWFN	M AO F N
MAWJC	M AO JH K
MAWJN	M AO JH N
MAWJT	M AO JH T
MAWM	M AO M
MAWNG	M AO NG
MAWRN	M AO R N
MAWSC	M AO S
MAWSM	M AO Z AH M
MAWSN	M AO S N
MAWSNG	M AO S NG
MAWST	M AO S T
MAX	M AE K S
MAXI	M AE K S IY
MAXN	M AE K S N
MAXNG	M AE K S NG
MAXNH	M AE K S N
MAXO	M AE K S OW
MAY	M EY
ME	M IY
MEE	M IY
MEEF	M IY F
MEEFM	M IY F M
MEEFN	M IY F N
MEEJ	M IY JH
MEEJNH	M IY JH N
MEEJT	M IY JH T
MEENH	M IY N
MEES	M IY Z
MEESCH	M IY S
MEESN	M IY Z N
MEESU	M IY S UW
MEEX	M IY K S
MEF	M EH F
MEFM	M EH F M
MEFN	M EH F N
MEFNG	M EH F NG
MEFO	M EH F OW
MEJ	M EH JH
MEJO	M EH JH OW
MEJP	M EH JH P
MEJT	M EH JH T
MEM	M EH M
MEN	M EH N
MEO	M IY OW
MER	M EH R
MER(2)	M ER
MERO	M EH R OW
MES	M IY Z
MESM	M EH Z AH M
MESN	M EH Z N
MESO	M EH S OW
MESP	M EH S
MEST	M EH S T
MEX	M EH K S
MEXO	M EH K S OW
MI	M IY
MIEEFN	M IY AH F N
MIEEFU	M IY AH F UW
MIEEJN	M IY AH JH N
MIEEJNG	M IY AH JH NG
MIEEJT	M IY AH JH T
MIEEN	M IY AH N
MIEENG	M IY AH NG
MIEESN	M IY AH Z N
MIEESNG	M IY AH Z NG
MIEEST	M IY AH S T
MIEESU	M IY AH S UW
MIEEU	M IY UW
MIEEXN	M IY AH K S N
MIEEXU	M IY EH K S UW
MIF	M IH F
MIFN	M IH F N
MIFNH	M IH F N
MIFU	M IH F UW
MIJ	M IH JH
MIJCH	M IH JH CH
MIJN	M IH JH N
MIJT	M IH JH T
MIN	M IH N
MINH	M IH N
MIR	M IH R
MIRA	M IH R AH
MIRM	M AH R M
MIS	M IH S
MISA	M IY Z AH
MISCH	M IH SH
MISM	M IH Z AH M
MISP	M IH S
MIST	M IH S T
MISU	M AH S UW
MIU	M AY UW
MIXM	M IH K S M
MO	M OW
MOAY	M OW IY
MOF	M AA F
MOFI	M OW F IY
MOFN	M AA F N
MOFNG	M AA F NG
MOI	M W AA
MOJ	M AA JH
MOJC	M AA JH K
MOJI	M OW JH IY
MOJN	M AA JH N
MOJNG	M AA JH NG
MOJT	M AA JH T
MOM	M AA M
MON	M OW N
MON(2)	M AA N
MONG	M AO NG
MOO	M UW
MOOF	M UW F
MOOFI	M UW F IY
MOOFM	M UW F M
MOOFNG	M UW F NG
MOOI	M UW IY
MOOJ	M UW JH
MOOJC	M UW JH K
MOOJI	M UW JH IY
MOOJNG	M UW JH NG
MOOJT	M UW JH T
MOOM	M UW M
MOON	M UW N
MOONG	M UW NG
MOOR	M UH R
MOORNG	M UH R NG
MOOS	M UW Z
MOOSC	M UW S
MOOSI	M UW S IY
MOOSNG	M UW Z NG
MOOST	M UW S T
MOOX	M UH K S
MOOXI	M UH K S IY
MOR	M AO R
MORI	M AO R IY
MORM	M AO R M
MORNG	M AO R NG
MOS	M AO S
MOSC	M AA S
MOSI	M OW S IY
MOSM	M AA Z AH M
MOSN	M AA Z N
MOSNG	M AA Z NG
MOSP	M AA S
MOST	M OW S T
MOST(2)	M OW S
MOW	M OW
MOWF	M OW F
MOWFI	M OW F IY
MOWFM	M OW F M
MOWJ	M OW JH
MOWN	M OW N
MOWR	M OW R
MOWRN	M OW R N
MOWS	M AW Z
MOWSI	M OW S IY
MOWSM	M OW Z AH M
MOWSN	M OW S N
MOWSP	M OW S
MOWX	M OW K S
MOX	M AA K S
MOXM	M AA K S M
MU	M UW
MUA	M Y UW AH
MUF	M AH F
MUFA	M Y UW F AH
MUFI	M Y UW F IY
MUFN	M AH F N
MUFNG	M AH F NG
MUI	M UW IH
MUJ	M AH JH
MUJC	M AH JH K
MUJI	M Y UW JH IY
MUJN	M AH JH N
MUJP	M AH JH P
MUJT	M AH JH T
MUM	M AH M
MUN	M AH N
MUNG	M AH NG
MUOOFNG	M Y UW UW F NG
MUOOI	M Y UW UW IY
MUOOJI	M Y UW AH JH IY
MUOOJN	M Y UW UW JH N
MUOON	M Y UW UW N
MUOONG	M Y UW UW NG
MUOOSI	M Y UW AH S IY
MUOOSN	M Y UW UW Z N
MUOOSNG	M Y UW UW Z NG
MUOOST	M Y UW UW S T
MUOOXI	M Y UW UH K S IY
MUOOXM	M Y UW AH K S M
MUOOXNG	M Y UW AH K S NG
MUR	M AH R
MURI	M UH R IY
MURM	M AH R M
MURN	M AH R N
MURNG	M AH R NG
MUS	M AH Z
MUSA	M Y UW S AH
MUSC	M AH S
MUSI	M Y UW S IY
MUSM	M AH Z AH M
MUSP	M AH S
MUST	M AH S T
MUWA	M AH W AH
MUWFNG	M AH W F NG
MUWJA	M AH W JH AH
MUWJC	M AH W JH K
MUWNG	M AH W NG
MUWOWFI	M AH W OW F IY
MUWOWFNG	M AH W OW F NG
MUWOWI	M AH W OW IY
MUWOWJN	M AH W OW JH N
MUWOWJT	M AH W OW JH T
MUWOWN	M AH W OW N
MUWOWNG	M AH W OW NG
MUWOWSN	M AH W OW S N
MUWOWSP	M AH W OW S
MUWOWST	M AH W OW S T
MUWOWXU	M AH W OW K S UW
MUWRA	M AH W R AH
MUWSA	M AH W S AH
MUWSC	M AH W S
MUWSN	M AH W S N
MUWST	M AH W S T
MUWU	M AH W UW
MUX	M AH K S
MUXI	M AH K S IY
MUXM	M AH K S M
MY	M AY
MYX	M IH K S
NA	N AA
NAAFM	N AA F M
NAAFN	N AA F N
NAAFY	N AA F IY
NAAJM	N AA JH M
NAAJNG	N AA JH NG
NAAJP	N AA JH P
NAAJU	N AA JH UW
NAAM	N AA M
NAANG	N AA NG
NAARY	N EY AH R IY
NAASC	N AA S
NAASM	N AA Z AH M
NAASN	N AA Z N
NAASNG	N AA Z NG
NAASP	N AA S
NAASU	N AA S UW
NAASY	N AA Z IY
NAAU	N AA UW
NAAXM	N AA K S M
NAAXNG	N AA K S NG
NAAXU	N AA K S UW
NAAXY	N AA K S IY
NAAY	N AA IY
NAF	N AE F
NAFI	N AE F IY
NAFN	N AE F N
NAFNG	N AE F NG
NAFNH	N AE F N
NAFO	N AE F OW
NAFY	N EY F IY
NAI	N EY
NAJ	N AE JH
NAJC	N AE JH K
NAJI	N AE JH IY
NAJM	N AE JH M
NAJN	N AE JH N
NAJNG	N AE JH NG
NAJNH	N AE JH N
NAJO	N AE JH OW
NAJP	N AE JH P
NAJT	N AE JH T
NAJY	N EY JH IY
NAM	N AE M
NAN	N AE N
NANG	N AE NG
NANH	N AE N
NAO	N EY OW
NAR	N AA R
NARI	N AE R IY
NARN	N AA R N
NARY	N EH R IY
NAS	N AE Z
NASC	N AE S
NASCH	N AE S
NASI	N AE S IY
NASM	N AE Z AH M
NASN	N AE Z N
NASNH	N AE Z N
NASO	N AA S OW
NAST	N AE S T
NASU	N AE S UW
NASY	N EY Z IY
NAU	N OW
NAWFM	N AO F M
NAWFN	N AO F N
NAWFNG	N AO F NG
NAWJC	N AO JH K
NAWJN	N AO JH N
NAWJNG	N AO JH NG
NAWM	N AO M
NAWN	N AO N
NAWNG	N AO NG
NAWRM	N AO R M
NAWSC	N AO S
NAWSM	N AO Z AH M
NAWSN	N AO S N
NAWSNG	N AO S NG
NAWSP	N AO S
NAWXNG	N AO K S NG
NAX	N AE K S
NAXO	N AE K S OW
NAXY	N AE K S IY
NAY	N EY
NE	N IY
NE(2)	N EY
NEE	N IY
NEEF	N IY F
NEEFN	N IY F N
NEEJ	N IY JH
NEEJM	N IY JH M
NEEJN	N IY JH N
NEEM	N IY M
NEEN	N IY AH N
NEER	N IH R
NEESM	N IY Z AH M
NEESN	N IY Z N
NEESP	N IY S
NEEST	N IY AH S T
NEESU	N IY S UW
NEEU	N IY UW
NEF	N EH F
NEFO	N EH F OW
NEJP	N EH JH P
NEJT	N EH JH T
NEM	N EH M
NEO	N IY OW
NER	N EH R
NERO	N IH R OW
NES	N EH S
NESM	N EH Z AH M
NESN	N EH Z N
NESO	N EH S OW
NESP	N EH S
NEST	N EH S T
NGA	N G AA
NGAAFM	N G AA F M
NGAAFN	N G AA F N
NGAAFU	N G AA F UW
NGAAFY	N G AA F IY
NGAAJM	N G AA JH M
NGAAJN	N G AA JH N
NGAAJP	N G AA JH P
NGAAJU	N G AA JH UW
NGAAJY	N G AA JH IY
NGAAM	N G AA M
NGAAN	N G EY AH N
NGAARM	N G AA R M
NGAARN	N G AA R N
NGAARNG	N G AA R NG
NGAASC	N G AA S
NGAASM	N G AA Z AH M
NGAASN	N G AA Z N
NGAASP	N G AA S
NGAAST	N G AA S T
NGAASU	N G AA S UW
NGAASY	N G AA Z IY
NGAAU	N G AA UW
NGAAXM	N G AA K S M
NGAAXU	N G AA K S UW
NGAAY	N G AA IY
NGAF	N G AE F
NGAFI	N G AE F IY
NGAFM	N G AE F M
NGAFN	N G AE F N
NGAFNG	N G AE F NG
NGAFNH	N G AE F N
NGAFO	N G AE F OW
NGAFY	N G EY F IY
NGAI	G AY
NGAI(2)	EH N G AY
NGAJC	N G AE JH K
NGAJCH	N G AE JH CH
NGAJI	N G AE JH IY
NGAJN	N G AE JH N
NGAJNH	N G AE JH N
NGAJO	N G AE JH OW
NGAJT	N G AE JH T
NGAM	N G AE M
NGAN	N G AE N
NGANG	N G AE NG
NGAO	N G EY OW
NGAR	N G AA R
NGARI	N G AE R IY
NGARNH	N G AA R N
NGARO	N G AE R OW
NGASC	N G AE S
NGASCH	N G AE S
NGASI	N G AE S IY
NGASM	N G AE Z AH M
NGASN	N G AE Z N
NGASNG	N G AE Z NG
NGASO	N G AE S OW
NGASP	N G AE S
NGAST	N G AE S T
NGASU	N G AE S UW
NGASY	N G EY Z IY
NGAU	N G AO
NGAWFN	N G AO F N
NGAWJT	N G AO JH T
NGAWM	N G AO M
NGAWN	N G AO N
NGAWRNG	N G AO R NG
NGAWSC	N G AO S
NGAWSM	N G AO Z AH M
NGAWSN	N G AO S N
NGAWST	N G AO S T
NGAWXNG	N G AO K S NG
NGAX	N G AE K S
NGAXI	N G AE K S IY
NGAXNG	N G AE K S NG
NGAY	N G EY IY
NGHE	N IY
NGHEE	N IY
NGHEEF	N IY F
NGHEEFU	N IY F UW
NGHEEJ	N IY JH
NGHEEJCH	N IY JH CH
NGHEEJN	N IY JH N
NGHEENH	N IY N
NGHEER	N IY AH R
NGHEERN	N IH R N
NGHEERNH	N IH R N
NGHEERU	N IH R UW
NGHEESCH	N IY S
NGHEEU	N IY UW
NGHEEX	N IY K S
NGHEEXNH	N IY K S N
NGHEEXU	N IY K S UW
NGHEF	N EH F
NGHEFO	N EH F OW
NGHEJ	N EH JH
NGHEJN	N EH JH N
NGHEJO	N EH JH OW
NGHEJT	N EH JH T
NGHERO	N EH R OW
NGHES	N Z
NGHESN	N EH Z N
NGHEXN	N EH K S N
NGHEXO	N EH K S OW
NGHI	G IY
NGHI(2)	EH N G IY
NGHIEEFN	N IY AH F N
NGHIEEJM	N IY AH JH M
NGHIEEJN	N IY AH JH N
NGHIEEJP	N IY AH JH P
NGHIEEJT	N IY AH JH T
NGHIEEM	N IY AH M
NGHIEEN	N IY AH N
NGHIEENG	N IY AH NG
NGHIEESN	N IY AH Z N
NGHIEEU	N IY UW
NGHIEEXM	N IY AH K S M
NGHIF	N IH F
NGHIFN	N IH F N
NGHIJ	N IH JH
NGHIJCH	N IH JH CH
NGHIJT	N IH JH T
NGHIJU	N IH JH UW
NGHINH	N IH N
NGHIR	N IH R
NGHIRNH	N AH R N
NGHIS	N IH Z
NGHISA	N IH S AH
NGHIU	N AY UW
NGHIX	N IH K S
NGHIXA	N IH K S AH
NGHIXNH	N IH K S N
NGO	EH NG G OW
NGOA	N G OW AH
NGOAFI	N G OW F IY
NGOAFM	N G OW F M
NGOAJC	N G OW JH K
NGOAJCH	N G OW JH CH
NGOAJI	N G OW JH IY
NGOAJM	N G OW JH M
NGOAJN	N G OW JH N
NGOAJY	N G OW JH IY
NGOAM	N G OW M
NGOAN	N G OW AH N
NGOANG	N G OW NG
NGOAO	N G OW OW
NGOARI	N G OW R IY
NGOARNG	N G OW R NG
NGOARNH	N G OW R N
NGOARY	N G OW AH R IY
NGOASC	N G OW S
NGOASI	N G OW S IY
NGOASO	N G OW S OW
NGOASP	N G OW S
NGOASY	N G OW Z IY
NGOAWFN	N G OW W F N
NGOAWFNG	N G OW W F NG
NGOAWJC	N G OW W JH K
NGOAWJT	N G OW W JH T
NGOAWRN	N G OW W R N
NGOAWSC	N G OW W S
NGOAWST	N G OW W S T
NGOAXN	N G OW K S N
NGOAY	N G OW IY
NGOE	N G OW
NGOEFO	N G OW AH F OW
NGOEJO	N G OW AH JH OW
NGOEM	N G OW AH M
NGOEN	N G OW AH N
NGOEO	N G OW AH OW
NGOERM	N G AH R M
NGOERN	N G AH R N
NGOERO	N G AH R OW
NGOES	N G OW Z
NGOESM	N G OW AH Z AH M
NGOESO	N G OW AH S OW
NGOEST	N G OW AH S T
NGOF	N G AA F
NGOFI	N G AA F IY
NGOFN	N G AA F N
NGOFNG	N G AA F NG
NGOI	N G OY
NGOJ	N G AA JH
NGOJA	N G AA JH AH
NGOJC	N G AA JH K
NGOJN	N G AA JH N
NGOJNG	N G AA JH NG
NGOJT	N G AA JH T
NGON	N G AA N
NGONG	N G AO NG
NGOO	N G UW
NGOOF	N G UW F
NGOOFI	N G UW F IY
NGOOFM	N G UW F M
NGOOFN	N G UW F N
NGOOFNG	N G UW F NG
NGOOI	N G UW IY
NGOOJ	N G UW JH
NGOOJC	N G UW JH K
NGOOJN	N G UW JH N
NGOOJT	N G UW JH T
NGOON	N G UW N
NGOONG	N G UW NG
NGOOR	N G OW AH R
NGOORM	N G UH R M
NGOORN	N G UH R N
NGOOS	N G UW Z
NGOOSC	N G UW S
NGOOSN	N G UW Z N
NGOOST	N G UW S T
NGOOX	N G UH K S
NGOOXNG	N G UH K S NG
NGOR	EH NG G AO R
NGORM	N G AO R M
NGORNG	N G AO R NG
NGOS	EH NG G OW Z
NGOSC	N G AA S
NGOSI	N G AA S IY
NGOSM	N G AA Z AH M
NGOSN	N G AA Z N
NGOSNG	N G AA Z NG
NGOSP	N G AA S
NGOST	N G AA S T
NGOW	N G OW
NGOWF	N G OW F
NGOWFI	N G OW F IY
NGOWI	N G OW IY
NGOWJ	N G OW JH
NGOWJI	N G OW JH IY
NGOWJM	N G OW JH M
NGOWJP	N G OW JH P
NGOWM	N G OW M
NGOWN	N G OW N
NGOWS	N G OW Z
NGOWSN	N G OW S N
NGOWSP	N G OW S
NGOWST	N G OW S T
NGOWX	N G OW K S
NGOX	N G AA K S
NGOXA	N G AA K S AH
NGOXI	N G AA K S IY
NGOXNG	N G AA K S NG
NGU	N G Y UW
NGUAARY	N G W EY AH R IY
NGUAAY	N G W AA IY
NGUEEJCH	N G W IY JH CH
NGUEESCH	N G W IY S
NGUF	N G AH F
NGUFI	N G Y UW F IY
NGUFN	N G AH F N
NGUFNG	N G AH F NG
NGUJ	N G AH JH
NGUJA	N G Y UW JH AH
NGUJC	N G AH JH K
NGUJM	N G AH JH M
NGUJP	N G AH JH P
NGUJT	N G AH JH T
NGUOOFI	N G W UW F IY
NGUOOFN	N G W UW F N
NGUOOI	N G W UW IY
NGUOOJI	N G W UW JH IY
NGUR	N G AH R
NGURI	N G Y UH R IY
NGURM	N G AH R M
NGURN	N G AH R N
NGURNG	N G AH R NG
NGUS	N G Y UW Z
NGUSC	N G AH S
NGUSNG	N G AH Z NG
NGUST	N G AH S T
NGUW	N G AH W
NGUWF	N G AH W F
NGUWFA	N G AH W F AH
NGUWFNG	N G AH W F NG
NGUWJ	N G AH W JH
NGUWJA	N G AH W JH AH
NGUWJC	N G AH W JH K
NGUWNG	N G AH W NG
NGUWOWFI	N G AH W OW F IY
NGUWOWFNG	N G AH W OW F NG
NGUWOWI	N G AH W OW IY
NGUWOWJC	N G AH W OW JH K
NGUWOWJNG	N G AH W OW JH NG
NGUWOWN	N G AH W OW N
NGUWOWRNG	N G AH W OW R NG
NGUWOWSC	N G AH W OW S
NGUWOWXNG	N G AH W OW K S NG
NGUWRA	N G AH W R AH
NGUWRI	N G AH W R IY
NGUWRNG	N G AH W R NG
NGUWS	N G AH W Z
NGUWSA	N G AH W S AH
NGUWU	N G AH W UW
NGUWX	N G AH W K S
NGUX	N G AH K S
NGUY	N G W IY
NGUYEEFN	N G W AY IY F N
NGUYEEJN	N G W AY IY JH N
NGUYEEJT	N G W AY IY JH T
NGUYEEN	N G W AY IY AH N
NGUYEEXN	N G W AY IY K S N
NGUYJ	N G W IH JH
NGUYRU	N G W IH R UW
NGUYST	N G W IH S T
NHA	N HH AA
NHAAFM	N HH AA F M
NHAAFN	N HH AA F N
NHAAFU	N HH AA F UW
NHAAFY	N HH AA F IY
NHAAJM	N HH AA JH M
NHAAJN	N HH AA JH N
NHAAJP	N HH AA JH P
NHAAJT	N HH AA JH T
NHAAJU	N HH AA JH UW
NHAAJY	N HH AA JH IY
NHAAM	N HH AA M
NHAAN	N HH EY AH N
NHAANG	N HH AA NG
NHAARM	N HH AA R M
NHAARN	N HH AA R N
NHAASC	N HH AA S
NHAASM	N HH AA Z AH M
NHAASN	N HH AA Z N
NHAASP	N HH AA S
NHAAST	N HH AA S T
NHAAU	N HH AA UW
NHAAXN	N HH AA K S N
NHAAXY	N HH AA K S IY
NHAAY	N HH AA IY
NHAF	N HH AE F
NHAFI	N HH AE F IY
NHAFM	N HH AE F M
NHAFN	N HH AE F N
NHAFNG	N HH AE F NG
NHAFNH	N HH AE F N
NHAFO	N HH AE F OW
NHAFU	N HH AE F UW
NHAI	N HH EY
NHAJC	N HH AE JH K
NHAJI	N HH AE JH IY
NHAJN	N HH AE JH N
NHAJNH	N HH AE JH N
NHAJO	N HH AE JH OW
NHAJP	N HH AE JH P
NHAJT	N HH AE JH T
NHAJY	N HH EY JH IY
NHAM	N HH AE M
NHAN	N HH AE N
NHANG	N HH AE NG
NHANH	N HH AE N
NHAO	N HH EY OW
NHAR	N HH AA R
NHARI	N HH AE R IY
NHARM	N HH AA R M
NHARN	N HH AA R N
NHARNH	N HH AA R N
NHARU	N HH AE R UW
NHARY	N HH AE R IY
NHAS	N HH AE Z
NHASC	N HH AE S
NHASCH	N HH AE S
NHASI	N HH AE S IY
NHASM	N HH AE Z AH M
NHASNG	N HH AE Z NG
NHASNH	N HH AE Z N
NHASO	N HH AE S OW
NHASP	N HH AE S
NHAST	N HH AE S T
NHASY	N HH EY Z IY
NHAU	N HH AO
NHAWFM	N HH AO F M
NHAWFN	N HH AO F N
NHAWFNG	N HH AO F NG
NHAWJM	N HH AO JH M
NHAWJN	N HH AO JH N
NHAWJNG	N HH AO JH NG
NHAWJT	N HH AO JH T
NHAWM	N HH AO M
NHAWN	N HH AO N
NHAWNG	N HH AO NG
NHAWRN	N HH AO R N
NHAWRNG	N HH AO R NG
NHAWSC	N HH AO S
NHAWSM	N HH AO Z AH M
NHAWSN	N HH AO S N
NHAWSNG	N HH AO S NG
NHAWSP	N HH AO S
NHAWST	N HH AO S T
NHAWXN	N HH AO K S N
NHAWXNG	N HH AO K S NG
NHAX	N HH AE K S
NHAXI	N HH AE K S IY
NHAXN	N HH AE K S N
NHAXNG	N HH AE K S NG
NHAXO	N HH AE K S OW
NHAY	N HH EY IY
NHE	N HH IY
NHEE	N HH IY
NHEEJN	N HH IY JH N
NHEEJU	N HH IY JH UW
NHEER	N HH IY AH R
NHEESCH	N HH IY S
NHEESU	N HH IY S UW
NHEEX	N HH IY K S
NHEF	N HH EH F
NHEFM	N HH EH F M
NHEFO	N HH EH F OW
NHEJ	N HH EH JH
NHEJM	N HH EH JH M
NHEJN	N HH EH JH N
NHEJO	N HH EH JH OW
NHEJP	N HH EH JH P
NHEJT	N HH EH JH T
NHEM	N HH EH M
NHEN	N HH EH N
NHEO	N HH IY OW
NHER	N HH EH R
NHERM	N HH AH R M
NHERO	N HH EH R OW
NHES	N HH S
NHESN	N HH EH Z N
NHESO	N HH EH S OW
NHESP	N HH EH S
NHEST	N HH EH S T
NHEX	N HH EH K S
NHEXO	N HH EH K S OW
NHI	N HH IY
NHIEEFU	N HH IY AH F UW
NHIEEJM	N HH IY AH JH M
NHIEEJT	N HH IY AH JH T
NHIEEN	N HH IY AH N
NHIEESC	N HH IY AH S
NHIEESP	N HH IY AH S
NHIEEU	N HH IY UW
NHIEEXM	N HH IY AH K S M
NHIEEXN	N HH IY AH K S N
NHIEEXU	N HH IY EH K S UW
NHIF	N HH IH F
NHIFN	N HH IH F N
NHIFU	N HH IH F UW
NHIJ	N HH IH JH
NHIJN	N HH IH JH N
NHIJP	N HH IH JH P
NHIJT	N HH IH JH T
NHIJU	N HH IH JH UW
NHINH	N HH IH N
NHIR	N HH IH R
NHIRNH	N HH AH R N
NHIS	N HH IH Z
NHISCH	N HH IH S
NHISM	N HH IH Z AH M
NHISN	N HH IH Z N
NHISP	N HH IH S
NHIST	N HH IH S T
NHISU	N HH IH S UW
NHIX	N HH IH K S
NHO	N HH OW
NHOAFI	N HH OW F IY
NHOAFM	N HH OW F M
NHOAI	N HH OW IY
NHOAJNG	N HH OW JH NG
NHOANG	N HH OW NG
NHOASNG	N HH OW Z NG
NHOASY	N HH OW Z IY
NHOAY	N HH OW IY
NHOE	N HH OW
NHOEF	N HH OW AH F
NHOEFN	N HH OW AH F N
NHOEJT	N HH OW AH JH T
NHOEN	N HH OW AH N
NHOERN	N HH AH R N
NHOES	N HH OW Z
NHOEST	N HH OW AH S T
NHOFA	N HH AA F AH
NHOFM	N HH AA F M
NHOFNG	N HH AA F NG
NHOI	N HH OY
NHOJ	N HH AA JH
NHOJC	N HH AA JH K
NHOJN	N HH AA JH N
NHOJT	N HH AA JH T
NHOM	N HH AA M
NHON	N HH AA N
NHONG	N HH AO NG
NHOO	N HH UW
NHOOFI	N HH UW F IY
NHOOFM	N HH UW F M
NHOOFNG	N HH UW F NG
NHOOI	N HH UW IY
NHOOJN	N HH UW JH N
NHOOJNG	N HH UW JH NG
NHOOJT	N HH UW JH T
NHOOM	N HH UW M
NHOON	N HH UW N
NHOONG	N HH UW NG
NHOOR	N HH OW AH R
NHOORM	N HH UH R M
NHOORN	N HH UH R N
NHOOS	N HH UW Z
NHOOSC	N HH UW S
NHOOSI	N HH UW S IY
NHOOSN	N HH UW Z N
NHOOST	N HH UW S T
NHOR	N HH AO R
NHORM	N HH AO R M
NHORN	N HH AO R N
NHORNG	N HH AO R NG
NHOS	N HH AA Z
NHOSA	N HH AA S AH
NHOSC	N HH AA S
NHOSI	N HH AA S IY
NHOSM	N HH AA Z AH M
NHOSN	N HH AA Z N
NHOSNG	N HH AA Z NG
NHOSP	N HH AA S
NHOST	N HH AA S T
NHOW	N HH OW
NHOWF	N HH OW F
NHOWFI	N HH OW F IY
NHOWFN	N HH OW F N
NHOWI	N HH OW IY
NHOWJ	N HH OW JH
NHOWJT	N HH OW JH T
NHOWM	N HH OW M
NHOWN	N HH OW N
NHOWR	N HH OW R
NHOWRI	N HH OW R IY
NHOWRN	N HH OW R N
NHOWS	N HH OW Z
NHOWSM	N HH OW Z AH M
NHOWSN	N HH OW S N
NHOWSP	N HH OW S
NHOWST	N HH OW S T
NHOWX	N HH OW K S
NHOWXN	N HH OW K S N
NHOX	N HH AA K S
NHOXM	N HH AA K S M
NHOXN	N HH AA K S N
NHOXNG	N HH AA K S NG
NHU	N HH UW
NHUAAFN	N HH Y UW AH F N
NHUAAJN	N HH Y UW AH JH N
NHUEEJ	N HH Y UW AH AH JH
NHUEES	N HH Y UW AH Z
NHUFI	N HH Y UW F IY
NHUFN	N HH AH F N
NHUFNG	N HH AH F NG
NHUI	N HH UW
NHUJ	N HH AH JH
NHUJA	N HH Y UW JH AH
NHUJC	N HH AH JH K
NHUJI	N HH Y UW JH IY
NHUJNG	N HH AH JH NG
NHUJT	N HH AH JH T
NHUJY	N HH Y UW JH IY
NHUM	N HH AH M
NHUNG	N HH AH NG
NHUOOFN	N HH Y UW UW F N
NHUOOJM	N HH Y UW UW JH M
NHUOOM	N HH Y UW UW M
NHUOOSC	N HH Y UW UW S
NHUOOSM	N HH Y UW UW Z AH M
NHUR	N HH AH R
NHURI	N HH Y UH R IY
NHURN	N HH AH R N
NHURNG	N HH AH R NG
NHUS	N HH AH Z
NHUSA	N HH Y UW S AH
NHUSC	N HH AH S
NHUSM	N HH AH Z AH M
NHUSN	N HH AH Z N
NHUSNG	N HH AH Z NG
NHUST	N HH AH S T
NHUW	N HH AH W
NHUWF	N HH AH W F
NHUWJA	N HH AH W JH AH
NHUWJT	N HH AH W JH T
NHUWNG	N HH AH W NG
NHUWOWFNG	N HH AH W OW F NG
NHUWOWJC	N HH AH W OW JH K
NHUWOWJNG	N HH AH W OW JH NG
NHUWOWNG	N HH AH W OW NG
NHUWOWXNG	N HH AH W OW K S NG
NHUWR	N HH AH W R
NHUWS	N HH AH W Z
NHUWSC	N HH AH W S
NHUWST	N HH AH W S T
NHUWX	N HH AH W K S
NHUWXNG	N HH AH W K S NG
NHUX	N HH AH K S
NHUXN	N HH AH K S N
NHUXNG	N HH AH K S NG
NHUYEEXN	N HH Y UW AY IY K S N
NI	N IY
NIA	N AY AH
NIEEFM	N IY AH F M
NIEEFNG	N IY AH F NG
NIEEJM	N IY AH JH M
NIEEJT	N IY AH JH T
NIEEJU	N IY AH JH UW
NIEEM	N IY AH M
NIEEN	N IY AH N
NIEEST	N IY AH S T
NIEEU	N IY UW
NIEEXNG	N IY AH K S NG
NIF	N IH F
NIFNH	N IH F N
NIJCH	N IH JH CH
NIJNH	N IH JH N
NIJT	N IH JH T
NIJU	N IH JH UW
NINH	N IH N
NIR	N IH R
NIS	N IH Z
NISCH	N IH S
NISN	N IH Z N
NISNH	N IH Z N
NISP	N IH S
NIST	N IH S T
NISU	N IH S UW
NIU	N AY UW
NIXA	N IH K S AH
NO	N OW
NOAXN	N OW K S N
NOF	N AA F
NOFI	N OW F IY
NOFM	N AA F M
NOFNG	N AA F NG
NOI	N OY
NOJ	N AA JH
NOJC	N AA JH K
NOJI	N OW JH IY
NOJN	N AA JH N
NOJNG	N AA JH NG
NOJT	N AA JH T
NOM	N AA M
NON	N AA N
NONG	N AO NG
NOO	N UW
NOOF	N UW F
NOOFI	N UW F IY
NOOFM	N UW F M
NOOFNG	N UW F NG
NOOI	N UW IY
NOOJ	N UW JH
NOOJI	N UW JH IY
NOOJM	N UW JH M
NOOJN	N UW JH N
NOOJP	N UW JH P
NOOM	N UW M
NOON	N UW N
NOONG	N UW NG
NOOR	N OW AH R
NOORI	N UH R IY
NOOS	N UW Z
NOOSC	N UW S
NOOSI	N UW S IY
NOOSNG	N UW Z NG
NOOSP	N UW S
NOOST	N UW S T
NOOX	N UH K S
NOOXI	N UH K S IY
NOOXNG	N UH K S NG
NOR	N AO R
NORI	N AO R IY
NORM	N AO R M
NOS	N OW Z
NOSC	N AA S
NOSI	N OW S IY
NOSN	N AA Z N
NOSNG	N AA Z NG
NOSP	N AA S
NOST	N AA S T
NOW	N AW
NOWI	N OW IY
NOWJ	N OW JH
NOWM	N OW M
NOWR	N OW R
NOWS	N AW Z
NOWSI	N OW S IY
NOWSP	N OW S
NOWST	N OW S T
NOWX	N OW K S
NOWXM	N OW K S M
NOX	N AA K S
NOXN	N AA K S N
NU	N UW
NUA	N Y UW AH
NUFI	N Y UW F IY
NUFNG	N AH F NG
NUJ	N AH JH
NUJC	N AH JH K
NUM	N AH M
NUNG	N AH NG
NUOOI	N Y UW UW IY
NUOOJC	N Y UW UW JH K
NUOOJT	N Y UW UW JH T
NUOONG	N Y UW UW NG
NUOOSI	N Y UW AH S IY
NUOOSM	N Y UW UW Z AH M
NUOOST	N Y UW UW S T
NURA	N Y UH R AH
NUS	N AH Z
NUSA	N Y UW S AH
NUSC	N AH S
NUSI	N Y UW S IY
NUSM	N AH Z AH M
NUSNG	N AH Z NG
NUSP	N AH S
NUST	N AH S T
NUW	N AH W
NUWA	N AH W AH
NUWFNG	N AH W F NG
NUWJC	N AH W JH K
NUWJNG	N AH W JH NG
NUWNG	N AH W NG
NUWOWFM	N AH W OW F M
NUWOWFNG	N AH W OW F NG
NUWOWJP	N AH W OW JH P
NUWOWNG	N AH W OW NG
NUWOWSC	N AH W OW S
NUWOWSNG	N AH W OW S NG
NUWRA	N AH W R AH
NUWSA	N AH W S AH
NUWSC	N AH W S
NUWSNG	N AH W S NG
NUWST	N AH W S T
NUWX	N AH W K S
NUWXA	N AH W K S AH
NUXNG	N AH K S NG
OA	OW AH
OAFM	OW F M
OAFNH	OW F N
OAI	OW IY
OAJCH	OW JH CH
OAJP	OW JH P
OAN	OW AH N
OANG	OW NG
OANH	OW N
OARI	OW R IY
OARN	OW R N
OASC	OW S
OASCH	OW S
OASI	OW S IY
OASN	OW Z N
OAST	OW S T
OAWFN	OW W F N
OAWJT	OW W JH T
OAWM	OW W M
OAWNG	OW W NG
OAWRNG	OW W R NG
OAWST	OW W S T
OE	OW
OER	OW AH R
OES	OW Z
OFA	AA F AH
OFI	AA F IY
OFM	AA F M
OFNG	AA F NG
OI	OY
OJC	AA JH K
OJE	OW JH
OJI	OW JH IY
OJP	AA JH P
OJT	AA JH T
OM	AA M
ONG	AO NG
OOFM	UW F M
OOFN	UW F N
OOFNG	UW F NG
OOI	UW IY
OOJC	UW JH K
OOJN	UW JH N
OOJP	UW JH P
OOM	UW M
OON	UW N
OONG	UW NG
OORI	UH R IY
OORN	UH R N
OORNG	UH R NG
OOSC	UW S
OOSI	UW S IY
OOSM	UW Z AH M
OOSNG	UW Z NG
OOSP	UW S
OOST	UW S T
ORI	AO R IY
ORM	AO R M
ORN	AO R N
ORNG	AO R NG
OSC	AA S
OSI	AA S IY
OSNG	AA Z NG
OSP	AA S
OST	OW S T
OWFI	OW F IY
OWI	OW IY
OWJT	OW JH T
OWN	OW N
OWSI	OW S IY
OWSM	OW Z AH M
OWSN	OW S N
OWST	OW S T
OWXM	OW K S M
OXNG	AA K S NG
PA	P AA
PAASC	P AA S
PAAU	P AA UW
PAF	P AE F
PAFI	P AE F IY
PAFNG	P AE F NG
PAI	P AA IY
PAJ	P AE JH
PAN	P AE N
PANG	P AE NG
PAR	P AA R
PASC	P AE S
PASN	P AE Z N
PAWFN	P AO F N
PE	P IY
PEE	P IY
PEN	P EH N
PER	P ER
PHA	F AA
PHAAFM	F AA F M
PHAAFN	F AA F N
PHAAJN	F AA JH N
PHAAJP	F AA JH P
PHAAJT	F AA JH T
PHAAN	F EY AH N
PHAARM	F AA R M
PHAARN	F AA R N
PHAARY	F EY AH R IY
PHAASN	F AA Z N
PHAASP	F AA S
PHAAST	F AA S T
PHAAXN	F AA K S N
PHAAXU	F AA K S UW
PHAAY	F AA IY
PHAF	F AE F
PHAFM	F AE F M
PHAFN	F AE F N
PHAFNG	F AE F NG
PHAFNH	F AE F N
PHAFO	F AE F OW
PHAI	F EY
PHAJ	F AE JH
PHAJCH	F AE JH CH
PHAJM	F AE JH M
PHAJN	F AE JH N
PHAJNG	F AE JH NG
PHAJT	F AE JH T
PHAN	F AE N
PHANG	F AE NG
PHANH	F AE N
PHAO	F EY OW
PHAR	F AA R
PHARI	F AE R IY
PHARN	F AA R N
PHARNG	F AA R NG
PHAS	F AE Z
PHASC	F AE S
PHASCH	F AE S
PHASI	F AE S IY
PHASN	F AE Z N
PHASO	F AE S OW
PHASP	F AE S
PHAST	F AE S T
PHAU	F AO
PHAWJNG	F AO JH NG
PHAWM	F AO M
PHAWN	F AO N
PHAWNG	F AO NG
PHAWRNG	F AO R NG
PHAWSC	F AO S
PHAWSN	F AO S N
PHAWSP	F AO S
PHAWST	F AO S T
PHAY	F EY IY
PHE	F IY
PHEE	F IY
PHEEF	F IY F
PHEEFNH	F IY F N
PHEEFU	F IY F UW
PHEEJ	F IY JH
PHEEJNH	F IY JH N
PHEEJT	F IY JH T
PHEEN	F IY AH N
PHEES	F IY Z
PHEESCH	F IY S
PHEEST	F IY AH S T
PHEEXN	F IY K S N
PHEEXU	F IY K S UW
PHEF	F EH F
PHEFN	F EH F N
PHEFNG	F EH F NG
PHEFO	F EH F OW
PHEJC	F EH JH K
PHEJT	F EH JH T
PHEN	F EH N
PHEO	F IY OW
PHESC	F EH S
PHESNG	F EH Z NG
PHESP	F EH S
PHEST	F EH S T
PHI	F AY
PHIEEFN	F IY AH F N
PHIEEJN	F IY AH JH N
PHIEEJT	F IY AH JH T
PHIEEJU	F IY AH JH UW
PHIEEN	F IY AH N
PHIEESM	F IY AH Z AH M
PHIEESN	F IY AH Z N
PHIEEST	F IY AH S T
PHIEESU	F IY AH S UW
PHIEEU	F IY UW
PHIF	F IH F
PHIFA	F IH F AH
PHIFN	F IH F N
PHIFNH	F IH F N
PHIJ	F IH JH
PHIJCH	F IH JH CH
PHIJU	F IH JH UW
PHIM	F IH M
PHIN	F IH N
PHINH	F IH N
PHIR	F IH R
PHIRNH	F AH R N
PHIS	F AY Z
PHISA	F IH S AH
PHISCH	F IH S
PHISM	F IH Z AH M
PHISNH	F IH Z N
PHIU	F AY UW
PHIXNH	F IH K S N
PHO	F OW
PHOF	F AA F
PHOFI	F OW F IY
PHOFNG	F AA F NG
PHOI	F OY
PHOJC	F AA JH K
PHOJT	F AA JH T
PHONG	F AO NG
PHOO	F UW
PHOOFM	F UW F M
PHOOFN	F UW F N
PHOOFNG	F UW F NG
PHOOI	F UW IY
PHOOM	F UW M
PHOONG	F UW NG
PHOOR	F OW AH R
PHOORI	F UH R IY
PHOORNG	F UH R NG
PHOOS	F UW Z
PHOOSC	F UW S
PHOOSI	F UW S IY
PHOOSP	F UW S
PHOOST	F UW S T
PHOOXNG	F UH K S NG
PHORNG	F AO R NG
PHOS	F AA Z
PHOSNG	F AA Z NG
PHOST	F AA S T
PHOW	F OW
PHOWF	F OW F
PHOWFI	F OW F IY
PHOWI	F OW IY
PHOWN	F OW N
PHOWR	F OW R
PHOWRN	F OW R N
PHOWSI	F OW S IY
PHOWSN	F OW S N
PHOWST	F OW S T
PHOWXN	F OW K S N
PHU	F UW
PHUA	F Y UW AH
PHUF	F AH F
PHUFN	F AH F N
PHUFNG	F AH F NG
PHUI	F UW
PHUJ	F AH JH
PHUJC	F AH JH K
PHUJNG	F AH JH NG
PHUJT	F AH JH T
PHUN	F AH N
PHUNG	F AH NG
PHUR	F AH R
PHURI	F Y UH R IY
PHURNG	F AH R NG
PHUS	F AH Z
PHUSC	F AH S
PHUSN	F AH Z N
PHUSNG	F AH Z NG
PHUST	F AH S T
PHUWJA	F AH W JH AH
PHUWJT	F AH W JH T
PHUWNG	F AH W NG
PHUWOWFNG	F AH W OW F NG
PHUWOWJNG	F AH W OW JH NG
PHUWOWJT	F AH W OW JH T
PHUWOWJU	F AH W OW JH UW
PHUWOWNG	F AH W OW NG
PHUWOWSC	F AH W OW S
PHUWOWSN	F AH W OW S N
PHUWOWXN	F AH W OW K S N
PHUWSA	F AH W S AH
PHUWSC	F AH W S
PHUWST	F AH W S T
PHUX	F AH K S
PI	P AY
PIN	P IH N
POO	P UW
POOJNG	P UW JH NG
POOOONG	P UW UW NG
POS	P AA S
POS(2)	P IY OW EH S
POW	P AW
POWF	P OW F
POWNG	P OW NG
PU	P UW
PUI	P UW
PUJA	P Y UW JH AH
PUOOJC	P Y UW UW JH K
PUWOWI	P AH W OW IY
QUA	K W AA
QUAAFN	K W AA F N
QUAAFNG	K W AA F NG
QUAAFY	K W AA F IY
QUAAJN	K W AA JH N
QUAAJT	K W AA JH T
QUAAJY	K W AA JH IY
QUAAN	K W EY AH N
QUAARN	K W AA R N
QUAARNG	K W AA R NG
QUAARY	K W EY AH R IY
QUAASN	K W AA Z N
QUAAST	K W AA S T
QUAASY	K W AA Z IY
QUAAXN	K W AA K S N
QUAAXY	K W AA K S IY
QUAAY	K W AA IY
QUAF	K W AA F
QUAFI	K W AA F IY
QUAFN	K W AA F N
QUAFNG	K W AA F NG
QUAFNH	K W AA F N
QUAFO	K W AA F OW
QUAFU	K W AA F UW
QUAFY	K W EY F IY
QUAI	K EY
QUAJ	K W AA JH
QUAJC	K W AA JH K
QUAJCH	K W AA JH CH
QUAJI	K W AA JH IY
QUAJNG	K W AA JH NG
QUAJNH	K W AA JH N
QUAJT	K W AA JH T
QUAJU	K W AA JH UW
QUAN	K W AO N
QUANG	K W AO NG
QUANH	K W AA N
QUAO	K W EY OW
QUAR	K W AE R
QUARI	K W AE R IY
QUARN	K W AO R N
QUARNG	K W AO R NG
QUARY	K W EH R IY
QUAS	K W AA Z
QUASC	K W AA S
QUASCH	K W AA S
QUASI	K W AA S IY
QUASN	K W AA Z N
QUASNG	K W AA Z NG
QUASNH	K W AA Z N
QUASO	K W AA S OW
QUAST	K W AA S T
QUAWFM	K W AO F M
QUAWFN	K W AO F N
QUAWJC	K W AO JH K
QUAWJM	K W AO JH M
QUAWJN	K W AO JH N
QUAWJNG	K W AO JH NG
QUAWJP	K W AO JH P
QUAWJT	K W AO JH T
QUAWN	K W AO N
QUAWNG	K W AO NG
QUAWRNG	K W AO R NG
QUAWSC	K W AO S
QUAWSM	K W AO Z AH M
QUAWSN	K W AO S N
QUAWSP	K W AO S
QUAWST	K W AO S T
QUAX	K W AE K S
QUAXNG	K W AE K S NG
QUAY	K IY
QUAY(2)	K EY
QUE	K Y UW
QUEE	K W IY IY
QUEEFNH	K W IY F N
QUEEFU	K W IY F UW
QUEEJ	K W IY JH
QUEEJCH	K W IY JH CH
QUEEJN	K W IY JH N
QUEEJT	K W IY JH T
QUEEN	K W IY N
QUEES	K IY Z
QUEEST	K IY AH S T
QUEF	K W EH F
QUEFN	K W EH F N
QUEFO	K W EH F OW
QUEJO	K W EH JH OW
QUEJT	K W EH JH T
QUEN	K W EH N
QUEO	K W IY OW
QUER	K AH R
QUES	K Y UW Z
QUES(2)	K W EH S
QUESO	K W EH S OW
QUEST	K W EH S T
QUEX	K W EH K S
QUI	K IY
QUIF	K W IH F
QUIJ	K W IH JH
QUIJT	K W IH JH T
QUIR	K W IH R
QUIS	K W AH S
QUIST	K W IH S T
QUIX	K W IH K S
QUOOSC	K W UW S
QUOW	K W OW
QUOWF	K W OW F
QUOWR	K W OW R
QUOWRN	K W OW R N
QUOWS	K W OW Z
QUOWSI	K W OW S IY
QUOWST	K W OW S T
QUY	K W IY
QUYEEFN	K W AY IY F N
QUYEEJN	K W AY IY JH N
QUYEEJT	K W AY IY JH T
QUYEEN	K W AY IY AH N
QUYEERN	K W AY AH R N
QUYEESN	K W AY IY Z N
QUYEEST	K W AY IY AH S T
QUYF	K W IH F
QUYFNH	K W IH F N
QUYJ	K W IH JH
QUYR	K W IH R
QUYS	K W IH Z
QUYSCH	K W IH S
QUYSNH	K W IH Z N
QUYX	K W IH K S
RA	R AA
RAAFM	R AA F M
RAAFN	R AA F N
RAAFU	R AA F UW
RAAFY	R AA F IY
RAAJM	R AA JH M
RAAJN	R AA JH N
RAAJP	R AA JH P
RAAJT	R AA JH T
RAAJU	R AA JH UW
RAAM	R AA M
RAAN	R EY AH N
RAARM	R AA R M
RAARY	R EY AH R IY
RAASM	R AA Z AH M
RAASN	R AA Z N
RAASP	R AA S
RAAST	R AA S T
RAAU	R AA UW
RAAXM	R AA K S M
RAAXY	R AA K S IY
RAAY	R AA IY
RAF	R AE F
RAFI	R AE F IY
RAFI(2)	R AA F IY
RAFN	R AE F N
RAFNG	R AE F NG
RAFNH	R AE F N
RAFO	R AE F OW
RAFY	R EY F IY
RAI	R AA IY
RAJ	R AA ZH
RAJ(2)	R AA JH
RAJC	R AE JH K
RAJCH	R AE JH CH
RAJM	R AE JH M
RAJN	R AE JH N
RAJNG	R AE JH NG
RAJO	R AE JH OW
RAJP	R AE JH P
RAJY	R EY JH IY
RAM	R AE M
RAN	R AE N
RANG	R AE NG
RANH	R AE N
RAO	R AW
RAR	R AA R
RARI	R AE R IY
RARNH	R AA R N
RARO	R AE R OW
RARY	R EH R IY
RAS	R AE S
RASC	R AE S
RASCH	R AE SH
RASI	R AE S IY
RASM	R AE Z AH M
RASN	R AE Z N
RASNG	R AE Z NG
RASO	R AA S OW
RASP	R AE S P
RAST	R AE S T
RASU	R AE S UW
RASY	R EY Z IY
RAU	R AW
RAWFM	R AO F M
RAWFN	R AO F N
RAWFNG	R AO F NG
RAWJC	R AO JH K
RAWJM	R AO JH M
RAWJN	R AO JH N
RAWJNG	R AO JH NG
RAWJT	R AO JH T
RAWM	R AO M
RAWN	R AO N
RAWNG	R AO NG
RAWSC	R AO S
RAWSM	R AO Z AH M
RAWSN	R AO S N
RAWSP	R AO S
RAX	R AE K S
RAXI	R AE K S IY
RAXNH	R AE K S N
RAXO	R AE K S OW
RAY	R EY
RE	R EY
RE(2)	R IY
REE	R IY
REEF	R IY F
REEFN	R IY EH F N
REEJP	R IY EH JH P
REEJT	R IY EH JH T
REEJU	R IY EH JH UW
REEN	R IY N
REER	R IY AH R
REES	R IY Z
REESCH	R IY EH S
REEST	R IY AH S T
REEU	R IY Y UW
REEX	R IY EH K S
REF	R EH F
REFM	R EH F M
REFN	R EH F N
REFO	R AH F OW
REJO	R AH JH OW
REM	R EH M
REN	R EH N
REO	R IY OW
RER	R EH R
RERO	R AH R OW
RES	R EY Z
RESN	R EH Z N
RESO	R IH Z OW
RESO(2)	R IY Z OW
RESO(3)	R IH S OW
RESO(4)	R IY S OW
REST	R EH S T
REX	R EH K S
RI	R IY
RIA	R IY AH
RIEEFNG	R IY AH F NG
RIEEJT	R IY AH JH T
RIEENG	R IY AH NG
RIEEST	R IY AH S T
RIEEU	R IY UW
RIF	R IH F
RIFA	R IH F AH
RIFNH	R IH F N
RIFU	R IH F UW
RIJ	R IH JH
RIJA	R IH JH AH
RIJCH	R IH JH CH
RIJN	R IY AH N
RIJP	R IH JH P
RIJT	R IH JH T
RIM	R IH M
RIN	R IH N
RINH	R IH N
RIR	R IH R
RIRA	R IH R AH
RIRNH	R AH R N
RIS	R IH Z
RISCH	R IH SH
RISM	R IH Z AH M
RIST	R IH S T
RISU	R IH S UW
RIU	R AY UW
RIX	R IH K S
RIXN	R IH K S N
RO	R OW
ROF	R AA F
ROFI	R OW F IY
ROFM	R AA F M
ROFNG	R AA F NG
ROI	R OY
ROJ	R AA JH
ROJC	R AA JH K
ROJI	R OW JH IY
ROJN	R AA JH N
ROJNG	R AA JH NG
ROJT	R AA JH T
RONG	R AO NG
ROO	R UW
ROOF	R UW F
ROOF(2)	R UH F
ROOFI	R UW F IY
ROOFNG	R UW F NG
ROOJ	R UW JH
ROOJC	R UW JH K
ROOJM	R UW JH M
ROOJN	R UW JH N
ROOJNG	R UW JH NG
ROOJP	R UW JH P
ROOM	R UW M
ROON	R UW N
ROONG	R UW NG
ROOR	R OW ER
ROORI	R UH R IY
ROORNG	R UH R NG
ROOSC	R UW S
ROOSI	R UW S IY
ROOSN	R UW Z N
ROOSNG	R UW Z NG
ROOST	R UW S T
ROOX	R UH K S
ROOXI	R UH K S IY
ROOXNG	R UH K S NG
ROR	R AO R
RORI	R AO R IY
RORM	R AO R M
ROS	R AO S
ROSC	R AA S
ROSI	R OW S IY
ROSM	R AA Z AH M
ROSN	R AA Z N
ROSNG	R AA Z NG
ROST	R AA S T
ROW	R OW
ROWF	R OW F
ROWFI	R OW F IY
ROWFM	R OW F M
ROWFN	R OW F N
ROWI	R OW IY
ROWJ	R OW JH
ROWJI	R OW JH IY
ROWJM	R OW JH M
ROWJN	R OW JH N
ROWJP	R OW JH P
ROWM	R OW M
ROWN	R OW N
ROWRM	R OW R M
ROWRN	R OW R N
ROWS	R OW Z
ROWSM	R OW Z AH M
ROWSP	R OW S
ROWST	R OW S T
ROWX	R OW K S
ROX	R AA K S
RU	R UW
RU(2)	AA R Y UW
RUA	R UW AH
RUEE	R UW IY
RUF	R AH F
RUFA	R UW F AH
RUFM	R AH F M
RUFN	R AH F N
RUFNG	R AH F NG
RUI	R UW
RUJC	R AH JH K
RUJI	R UW JH IY
RUJNG	R AH JH NG
RUJT	R AH JH T
RUM	R AH M
RUN	R AH N
RUNG	R AH NG
RUOOFI	R UW W AH F IY
RUOOFNG	R UW W UW F NG
RUOOJM	R UW W UW JH M
RUOOJNG	R UW W UW JH NG
RUOOJT	R UW W UW JH T
RUOORI	R UW W AH R IY
RUOOSC	R UW W UW S
RUOOXNG	R UW W AH K S NG
RUR	R AH R
RURA	R UH R AH
RURI	R UH R IY
RURN	R AH R N
RURNG	R AH R NG
RUS	R AH S
RUSC	R AH S
RUSN	R AH Z N
RUSNG	R AH Z NG
RUST	R AH S T
RUW	R AH W
RUWA	R AH W AH
RUWFNG	R AH W F NG
RUWJA	R AH W JH AH
RUWJC	R AH W JH K
RUWNG	R AH W NG
RUWOWFI	R AH W OW F IY
RUWOWFM	R AH W OW F M
RUWOWFN	R AH W OW F N
RUWOWFNG	R AH W OW F NG
RUWOWI	R AH W OW IY
RUWOWJI	R AH W OW JH IY
RUWOWJN	R AH W OW JH N
RUWOWJT	R AH W OW JH T
RUWOWJU	R AH W OW JH UW
RUWOWNG	R AH W OW NG
RUWOWRI	R AH W OW R IY
RUWOWSC	R AH W OW S
RUWOWSI	R AH W OW S IY
RUWOWSM	R AH W OW Z AH M
RUWOWSN	R AH W OW S N
RUWOWXI	R AH W OW K S IY
RUWRA	R AH W R AH
RUWSA	R AH W S AH
RUWSC	R AH W S
RUWST	R AH W S T
RUWXA	R AH W K S AH
RUX	R AH K S
RUXA	R AH K S AH
SA	S AA
SAAFM	S AA F M
SAAFN	S AA F N
SAAFU	S AA F UW
SAAFY	S AA F IY
SAAJM	S AA JH M
SAAJP	S AA JH P
SAAJT	S AA JH T
SAAJU	S AA JH UW
SAAJY	S AA JH IY
SAAM	S AA M
SAAN	S EY AH N
SAANG	S AA NG
SAARM	S AA R M
SAARN	S AA R N
SAARY	S EY AH R IY
SAASM	S AA Z AH M
SAASN	S AA Z N
SAASP	S AA S
SAAST	S AA S T
SAASU	S AA S UW
SAASY	S AA Z IY
SAAU	S AA UW
SAAXM	S AA K S M
SAAY	S AA IY
SAF	S AE F
SAFI	S AE F IY
SAFM	S AE F M
SAFN	S AE F N
SAFNG	S AE F NG
SAFNH	S AE F N
SAFO	S AE F OW
SAI	S AY
SAI(2)	EH S EY AY
SAJ	S AE JH
SAJC	S AE JH K
SAJCH	S AE JH CH
SAJI	S AE JH IY
SAJM	S AE JH M
SAJN	S AE JH N
SAJO	S AE JH OW
SAJP	S AE JH P
SAJT	S AE JH T
SAM	S AE M
SAN	S AE N
SANG	S AE NG
SANH	S AE N
SAO	S AW
SAR	S AA R
SARI	S AA R IY
SARN	S AA R N
SARNG	S AA R NG
SARNH	S AA R N
SARO	S AE R OW
SARY	S AE R IY
SAS	S AE S
SASC	S AE S
SASCH	S AE S
SASI	S AE S IY
SASM	S AE Z AH M
SASN	S AE Z N
SASNG	S AE Z NG
SASNH	S AE Z N
SASO	S AE S OW
SASP	S AE S
SAST	S AE S T
SASU	S AE S UW
SAU	S AO
SAWFNG	S AO F NG
SAWJC	S AO JH K
SAWJM	S AO JH M
SAWJT	S AO JH T
SAWM	S AO M
SAWN	S AO N
SAWNG	S AO NG
SAWSC	S AO S
SAWSM	S AO Z AH M
SAWSN	S AO S N
SAWSNG	S AO S NG
SAWSP	S AO S
SAWST	S AO S T
SAWXN	S AO K S N
SAX	S AE K S
SAXI	S AE K S IY
SAY	S EY
SE	S EY
SEE	S IY
SEEF	S IY F
SEEFN	S IY F N
SEEJ	S IY JH
SEEJT	S IY JH T
SEEN	S IY N
SEENH	S IY N
SEERNH	S IH R N
SEESN	S IY Z N
SEESU	S IY S UW
SEEU	S IY UW
SEEX	S IY K S
SEF	S EH F
SEFO	S EH F OW
SEJO	S EH JH OW
SEN	S EH N
SEO	S IY OW
SEO(2)	S EY OW
SER	S EH R
SERN	S AH R N
SESC	S EH S
SESM	S EH Z AH M
SEST	S EH S T
SEX	S EH K S
SI	S IY
SIEENG	S IY AH NG
SIEERM	S IY AH R M
SIEERNG	S IY AH R NG
SIEEST	S IY AH S T
SIEEU	S IY UW
SIEEXN	S IY AH K S N
SIF	S IH F
SIFN	S IH F N
SIFNH	S IH F N
SIJA	S IH JH AH
SIJCH	S IH JH CH
SIJP	S IH JH P
SIJT	S IH JH T
SIM	S IH M
SIN	S IH N
SINH	S IH N
SIR	S ER
SIRA	S IH R AH
SIRNH	S AH R N
SISN	S IH Z N
SISNH	S IH Z N
SIST	S IH S T
SIU	S IY UW
SIX	S IH K S
SO	S OW
SOA	S OW AH
SOAFI	S OW F IY
SOAJN	S OW JH N
SOAJNG	S OW JH NG
SOAJT	S OW JH T
SOASI	S OW S IY
SOASN	S OW Z N
SOAST	S OW S T
SOF	S AA F
SOFA	S OW F AH
SOFI	S OW F IY
SOFM	S AA F M
SOFN	S AA F N
SOFNG	S AA F NG
SOI	S OY
SOJ	S AA JH
SOJC	S AA JH K
SOJM	S AA JH M
SOJT	S AA JH T
SON	S AH N
SONG	S AO NG
SOO	S UW
SOOF	S UW F
SOOFI	S UW F IY
SOOFN	S UW F N
SOOFNG	S UW F NG
SOOI	S UW IY
SOOJ	S UW JH
SOOJP	S UW JH P
SOOJT	S UW JH T
SOONG	S UW NG
SOOR	S OW AH R
SOORNG	S UH R NG
SOOS	S UW Z
SOOSC	S UW S
SOOSNG	S UW Z NG
SOOST	S UW S T
SOOX	S UH K S
SOR	S AO R
SORI	S AO R IY
SOSC	S AA S
SOSI	S OW S IY
SOSM	S AA Z AH M
SOSN	S AA Z N
SOSNG	S AA Z NG
SOST	S AA S T
SOW	S AW
SOW(2)	S OW
SOWF	S OW F
SOWFM	S OW F M
SOWFN	S OW F N
SOWJ	S OW JH
SOWJI	S OW JH IY
SOWM	S OW M
SOWN	S OW N
SOWR	S OW R
SOWRI	S OW R IY
SOWRN	S OW R N
SOWS	S OW Z
SOWSM	S OW Z AH M
SOWSN	S OW S N
SOWST	S OW S T
SOWX	S OW K S
SOXI	S AA K S IY
SOXNG	S AA K S NG
SU	S UW
SUAAST	S W EY AH S T
SUEE	S UW IY
SUF	S AH F
SUFI	S UW F IY
SUFM	S AH F M
SUFNG	S AH F NG
SUI	S UW IY
SUI(2)	S W IY
SUJ	S AH JH
SUJA	S UW JH AH
SUJC	S AH JH K
SUJM	S AH JH M
SUJN	S AH JH N
SUJP	S AH JH P
SUJT	S AH JH T
SUM	S AH M
SUN	S AH N
SUNG	S AH NG
SUOOFNG	S UW W UW F NG
SUOON	S UW W UW N
SUOONG	S UW W UW NG
SUOOSI	S UW W AH S IY
SUOOST	S UW W UW S T
SUR	S ER
SURA	S UH R AH
SURI	S UH R IY
SURNG	S AH R NG
SUS	S AH S
SUSC	S AH S
SUSN	S AH Z N
SUSNG	S AH Z NG
SUSP	S AH S
SUST	S AH S T
SUSY	S UW Z IY
SUW	S AH W
SUWA	S AH W AH
SUWFN	S AH W F N
SUWFNG	S AH W F NG
SUWJ	S AH W JH
SUWJC	S AH W JH K
SUWJT	S AH W JH T
SUWNG	S AH W NG
SUWOWFN	S AH W OW F N
SUWOWFNG	S AH W OW F NG
SUWOWJNG	S AH W OW JH NG
SUWOWJT	S AH W OW JH T
SUWOWNG	S AH W OW NG
SUWOWRI	S AH W OW R IY
SUWOWSNG	S AH W OW S NG
SUWOWST	S AH W OW S T
SUWR	S AH W R
SUWRA	S AH W R AH
SUWRNG	S AH W R NG
SUWRU	S AH W R UW
SUWS	S AH W Z
SUWSA	S AH W S AH
SUWSC	S AH W S
SUWST	S AH W S T
SUWU	S AH W UW
SUWXA	S AH W K S AH
SUWXNG	S AH W K S NG
SUXNG	S AH K S NG
SUY	S UW IY
SUYEEFN	S UW W AY IY F N
SUYEERN	S UW W AY AH R N
SUYEEXN	S UW W AY IY K S N
SUYST	S UW W AH S T
SYX	S IH K S
TA	T AA
TAAFM	T AA F M
TAAFN	T AA F N
TAAFNG	T AA F NG
TAAFY	T AA F IY
TAAJN	T AA JH N
TAAJP	T AA JH P
TAAJT	T AA JH T
TAAJU	T AA JH UW
TAAM	T AA M
TAAN	T EY AH N
TAANG	T AA NG
TAARM	T AA R M
TAARN	T AA R N
TAARU	T AA R UW
TAARY	T EY AH R IY
TAASC	T AA S
TAASM	T AA Z AH M
TAASN	T AA Z N
TAASP	T AA S
TAAST	T AA S T
TAASU	T AA S UW
TAASY	T AA Z IY
TAAU	T AA UW
TAAXN	T AA K S N
TAAY	T AA IY
TAF	T AE F
TAFI	T AE F IY
TAFM	T AE F M
TAFN	T AE F N
TAFNG	T AE F NG
TAFNH	T AE F N
TAFO	T AE F OW
TAFU	T AE F UW
TAFY	T EY F IY
TAI	T AY
TAJ	T AA ZH
TAJC	T AE JH K
TAJCH	T AE JH CH
TAJI	T AE JH IY
TAJM	T AE JH M
TAJNG	T AE JH NG
TAJNH	T AE JH N
TAJO	T AE JH OW
TAJP	T AE JH P
TAJT	T AE JH T
TAM	T AE M
TAN	T AE N
TANG	T AE NG
TANG(2)	T AA NG
TANH	T AE N
TAO	T AW
TAO(2)	D AW
TAR	T AA R
TARI	T AE R IY
TARN	T AA R N
TARNG	T AA R NG
TARO	T EH R OW
TAS	T AE Z
TASC	T AE S
TASCH	T AE SH
TASI	T AE S IY
TASM	T AE S AH M
TASN	T AE Z N
TASNG	T AE Z NG
TASNH	T AE Z N
TASO	T AE S OW
TASP	T AE S
TAST	T AE S T
TASU	T AE S UW
TASY	T EY Z IY
TAWFM	T AO F M
TAWFN	T AO F N
TAWFNG	T AO F NG
TAWJC	T AO JH K
TAWJNG	T AO JH NG
TAWM	T AO M
TAWN	T AO N
TAWNG	T AO NG
TAWSC	T AO S
TAWSM	T AO Z AH M
TAWSN	T AO S N
TAWSP	T AO S
TAWST	T AO S T
TAX	T AE K S
TAXI	T AE K S IY
TAY	T EY
TE	T IY
TEE	T IY
TEEF	T IY F
TEEFNH	T IY F N
TEEJ	T IY JH
TEEM	T IY M
TEEN	T IY N
TEENH	T IY N
TEER	T IH R
TEERNH	T IH R N
TEES	T IY Z
TEESCH	T IY S
TEEST	T IY AH S T
TEESU	T IY S UW
TEEU	T IY UW
TEEX	T IY K S
TEEXNH	T IY K S N
TEF	T EH F
TEFM	T EH F M
TEFO	T EH F OW
TEJO	T EH JH OW
TEJP	T EH JH P
TEJT	T EH JH T
TEM	T EH M
TEN	T EH N
TENG	T EH NG
TEO	T EY OW
TER	T ER
TERO	T EH R OW
TES	T S
TESM	T EH Z AH M
TESN	T EH Z N
TESP	T EH S
TEST	T EH S T
TEX	T EH K S
TEXN	T EH K S N
THA	TH AA
THAAFM	TH AA F M
THAAFN	TH AA F N
THAAFU	TH AA F UW
THAAFY	TH AA F IY
THAAJM	TH AA JH M
THAAJN	TH AA JH N
THAAJP	TH AA JH P
THAAJT	TH AA JH T
THAAM	TH AA M
THAAN	TH EY AH N
THAARM	TH AA R M
THAARN	TH AA R N
THAARU	TH AA R UW
THAASM	TH AA Z AH M
THAASP	TH AA S
THAAST	TH AA S T
THAASU	TH AA S UW
THAASY	TH AA Z IY
THAAU	TH AA UW
THAAXM	TH AA K S M
THAAXN	TH AA K S N
THAAY	TH AA IY
THAF	TH AE F
THAFI	TH AE F IY
THAFM	TH AE F M
THAFNG	TH AE F NG
THAFNH	TH AE F N
THAFO	TH AE F OW
THAFY	TH EY F IY
THAI	T AY
THAJC	TH AE JH K
THAJCH	TH AE JH CH
THAJNH	TH AE JH N
THAJO	TH AE JH OW
THAJP	TH AE JH P
THAM	TH AE M
THAN	DH AE N
THAN(2)	DH AH N
THANG	TH AE NG
THANH	TH AE N
THAO	DH AW
THAR	TH AA R
THARI	TH AE R IY
THARM	TH AA R M
THARN	TH AA R N
THARNG	TH AA R NG
THARNH	TH AA R N
THARO	TH AE R OW
THARY	TH AE R IY
THAS	TH AE Z
THASC	TH AE S
THASCH	TH AE S
THASI	TH AE S IY
THASM	TH AE Z AH M
THASN	TH AE Z N
THASNG	TH AE Z NG
THASNH	TH AE Z N
THASO	TH AE S OW
THASP	TH AE S
THAST	TH AE S T
THASU	TH AE S UW
THASY	TH EY Z IY
THAU	DH AW
THAWFN	TH AO F N
THAWFNG	TH AO F NG
THAWJNG	TH AO JH NG
THAWM	TH AO M
THAWN	TH AO N
THAWNG	TH AO NG
THAWRM	TH AO R M
THAWRNG	TH AO R NG
THAWSC	TH AO S
THAWSM	TH AO Z AH M
THAWSN	TH AO S N
THAWSNG	TH AO S NG
THAWSP	TH AO S
THAWST	TH AO S T
THAXI	TH AE K S IY
THAY	TH EY IY
THE	DH AH
THE(2)	DH IY
THEE	DH IY
THEEF	TH IY F
THEEFM	TH IY F M
THEEFU	TH IY F UW
THEEJ	TH IY JH
THEEJN	TH IY JH N
THEEM	TH IY M
THEENH	TH IY N
THEER	DH IY AH R
THEERNH	TH IH R N
THEERU	TH IH R UW
THEES	DH IY Z
THEESCH	TH IY S
THEESP	TH IY S
THEEST	DH IY AH S T
THEEU	TH IY UW
THEF	TH EH F
THEFM	TH EH F M
THEFN	TH EH F N
THEFO	TH EH F OW
THEJN	TH EH JH N
THEJO	TH EH JH OW
THEJP	TH EH JH P
THEN	DH EH N
THEO	TH IY OW
THER	TH EH R
THERO	TH EH R OW
THES	DH AH Z
THESP	TH EH S
THEST	TH EH S T
THI	TH IY
THIA	TH AY AH
THIEEFM	TH IY AH F M
THIEEFN	TH IY AH F N
THIEEFNG	TH IY AH F NG
THIEEFU	TH IY AH F UW
THIEEJN	TH IY AH JH N
THIEEJP	TH IY AH JH P
THIEEJT	TH IY AH JH T
THIEEJU	TH IY AH JH UW
THIEEM	TH IY AH M
THIEEN	TH IY AH N
THIEENG	TH IY AH NG
THIEERM	TH IY AH R M
THIEERN	TH IY AH R N
THIEERU	TH IY AH R UW
THIEESC	TH IY AH S
THIEESN	TH IY AH Z N
THIEESP	TH IY AH S
THIEEST	TH IY AH S T
THIEESU	TH IY AH S UW
THIEEU	TH IY UW
THIF	TH IH F
THIFA	TH IH F AH
THIFN	TH IH F N
THIFNH	TH IH F N
THIJ	TH IH JH
THIJCH	TH IH JH CH
THIJNH	TH IH JH N
THIJT	TH IH JH T
THIJU	TH IH JH UW
THIN	TH IH N
THINH	TH IH N
THIR	TH IH R
THIRNH	TH AH R N
THIRU	TH IH R UW
THIS	DH IH S
THISA	TH IH S AH
THISCH	TH IH S
THISM	TH IH Z AH M
THISN	TH IH Z N
THISNH	TH IH Z N
THISP	TH IH S
THIST	TH IH S T
THIU	TH AY UW
THO	DH OW
THOA	TH OW AH
THOAI	TH OW IY
THOAJI	TH OW JH IY
THOAJT	TH OW JH T
THOANG	TH OW NG
THOAR	TH OW AH R
THOARI	TH OW R IY
THOARNG	TH OW R NG
THOASI	TH OW S IY
THOASN	TH OW Z N
THOASNG	TH OW Z NG
THOAST	TH OW S T
THOAWN	TH OW W N
THOAWSNG	TH OW W S NG
THOAWST	TH OW W S T
THOF	TH AA F
THOFA	TH OW F AH
THOFI	TH OW F IY
THOFM	TH AA F M
THOFNG	TH AA F NG
THOI	TH OY
THOJ	TH AA JH
THOJC	TH AA JH K
THOJT	TH AA JH T
THOM	T AA M
THON	TH AA N
THONG	TH AO NG
THOO	TH UW
THOOF	TH UW F
THOOFI	TH UW F IY
THOOFM	TH UW F M
THOOFN	TH UW F N
THOOFNG	TH UW F NG
THOOI	TH UW IY
THOOJC	TH UW JH K
THOOJN	TH UW JH N
THOOJP	TH UW JH P
THOON	TH UW N
THOONG	TH UW NG
THOOR	TH OW AH R
THOORI	TH UH R IY
THOORN	TH UH R N
THOOS	TH UW Z
THOOSC	TH UW S
THOOSI	TH UW S IY
THOOSN	TH UW Z N
THOOSNG	TH UW Z NG
THOOST	TH UW S T
THOOXN	TH UH K S N
THOR	TH AO R
THORI	TH AO R IY
THORM	TH AO R M
THOS	DH OW Z
THOSA	TH OW S AH
THOSC	TH AA S
THOSI	TH OW S IY
THOSP	TH AA S
THOST	TH AA S T
THOW	TH OW
THOWF	TH OW F
THOWFI	TH OW F IY
THOWFN	TH OW F N
THOWI	TH OW IY
THOWJ	TH OW JH
THOWJT	TH OW JH T
THOWM	TH OW M
THOWN	TH OW N
THOWR	TH OW R
THOWS	TH OW Z
THOWSI	TH OW S IY
THOWST	TH OW S T
THOXA	TH AA K S AH
THOXNG	TH AA K S NG
THU	TH UW
THUA	TH UW W AH
THUAAFN	TH UW W AH F N
THUAAJN	TH UW W AH JH N
THUAAJT	TH UW W AH JH T
THUAASN	TH UW W AH Z N
THUAAXN	TH UW W AH K S N
THUEE	TH UW W IY IY
THUEER	TH UW W IH R
THUEES	TH UW AH S
THUF	TH AH F
THUFA	TH UW F AH
THUFM	TH AH F M
THUFNG	TH AH F NG
THUI	TH UW
THUJ	TH AH JH
THUJC	TH AH JH K
THUJI	TH UW JH IY
THUJNG	TH AH JH NG
THUJP	TH AH JH P
THUJT	TH AH JH T
THUM	TH AH M
THUN	TH AH N
THUNG	TH AH NG
THUOOFN	TH UW W UW F N
THUOOFNG	TH UW W UW F NG
THUOOJC	TH UW W UW JH K
THUOOJM	TH UW W UW JH M
THUOOJT	TH UW W UW JH T
THUOON	TH UW W UW N
THUOORNG	TH UW W AH R NG
THUOOSC	TH UW W UW S
THUOOSN	TH UW W UW Z N
THUOOXN	TH UW W AH K S N
THUOWR	TH UW W OW R
THUR	DH ER
THURA	TH UH R AH
THURI	TH UH R IY
THURM	TH ER M
THURNG	TH AH R NG
THUS	DH AH S
THUSC	TH AH S
THUSI	TH UW S IY
THUSNG	TH AH Z NG
THUST	TH AH S T
THUSY	DH AH S IY
THUW	TH AH W
THUWA	TH AH W AH
THUWF	TH AH W F
THUWFA	TH AH W F AH
THUWFNG	TH AH W F NG
THUWJ	TH AH W JH
THUWJC	TH AH W JH K
THUWNG	TH AH W NG
THUWOWFN	TH AH W OW F N
THUWOWFNG	TH AH W OW F NG
THUWOWJC	TH AH W OW JH K
THUWOWJNG	TH AH W OW JH NG
THUWOWJT	TH AH W OW JH T
THUWOWNG	TH AH W OW NG
THUWOWRNG	TH AH W OW R NG
THUWOWSC	TH AH W OW S
THUWOWSNG	TH AH W OW S NG
THUWOWST	TH AH W OW S T
THUWOWXN	TH AH W OW K S N
THUWR	TH AH W R
THUWRA	TH AH W R AH
THUWS	TH AH W Z
THUWSC	TH AH W S
THUWXNG	TH AH W K S NG
THUXNG	TH AH K S NG
THUYEEFN	TH UW W AY IY F N
THUYEEN	TH UW W AY IY AH N
THUYEEST	TH UW W AY IY AH S T
THUYF	TH UW W AH F
THUYJ	TH UW W AH JH
THUYR	TH UW W AH R
THUYS	TH UW W AH Z
TI	T IY
TIA	T IY AH
TIEEFM	T IY AH F M
TIEEFN	T IY AH F N
TIEEFU	T IY AH F UW
TIEEJC	T IY AH JH K
TIEEJM	T IY AH JH M
TIEEJN	T IY AH JH N
TIEEJP	T IY AH JH P
TIEEJT	T IY AH JH T
TIEEM	T IY AH M
TIEEN	T AY AH N
TIEENG	T IY AH NG
TIEERN	T IY AH R N
TIEERU	T IY AH R UW
TIEESC	T IY AH S
TIEESM	T IY AH Z AH M
TIEESN	T IY AH Z N
TIEESNG	T IY AH Z NG
TIEESP	T IY AH S
TIEEST	T AY AH S T
TIEESU	T IY AH S UW
TIEEU	T IY UW
TIEEXN	T IY AH K S N
TIEEXU	T IY EH K S UW
TIF	T IH F
TIFM	T IH F M
TIFNH	T IH F N
TIJ	T IH JH
TIJCH	T IH JH CH
TIJNH	T IH JH N
TIJT	T IH JH T
TIJU	T IH JH UW
TIM	T IH M
TIN	T IH N
TINH	T IH N
TIR	T IH R
TIRA	T IH R AH
TIRM	T AH R M
TIRNH	T AH R N
TIS	T IH Z
TISA	T IH S AH
TISCH	T IH SH
TISM	T IH Z AH M
TISN	T IH Z N
TISNH	T IH Z N
TIST	T IH S T
TISU	T IH S UW
TIU	T AY UW
TIX	T IH K S
TIXN	T IH K S N
TIXNH	T IH K S N
TIXU	T IH K S UW
TO	T UW
TO(2)	T IH
TO(3)	T AH
TOA	T OW AA
TOAF	T OW F
TOAFI	T OW F IY
TOAFN	T OW F N
TOAFNG	T OW F NG
TOAJ	T OW JH
TOAJC	T OW JH K
TOAJI	T OW JH IY
TOAJNG	T OW JH NG
TOAN	T OW AH N
TOANG	T OW NG
TOANH	T OW N
TOAR	T OW ER
TOARN	T OW R N
TOASC	T OW S
TOASI	T OW S IY
TOASN	T OW Z N
TOAST	T OW S T
TOE	T OW
TOEF	T OW AH F
TOEJT	T OW AH JH T
TOEN	T OW AH N
TOES	T OW Z
TOEST	T OW AH S T
TOF	T AA F
TOFI	T OW F IY
TOFM	T AA F M
TOFN	T AA F N
TOFNG	T AA F NG
TOI	T OY
TOJ	T AA JH
TOJC	T AA JH K
TOJNG	T AA JH NG
TOJP	T AA JH P
TOJT	T AA JH T
TOM	T AA M
TON	T AH N
TONG	T AO NG
TOO	T UW
TOOF	T UW F
TOOFI	T UW F IY
TOOFN	T UW F N
TOOFNG	T UW F NG
TOOI	T UW IY
TOOJ	T UW JH
TOOJC	T UW JH K
TOOJI	T UW JH IY
TOOJT	T UW JH T
TOOM	T UW M
TOON	T UW N
TOONG	T UW NG
TOOR	T OW ER
TOORN	T UH R N
TOORNG	T UH R NG
TOOS	T UW Z
TOOSC	T UW S
TOOSI	T UW S IY
TOOSN	T UW Z N
TOOSNG	T UW Z NG
TOOSP	T UW S
TOOST	T UW S T
TOR	T AO R
TORI	T AO R IY
TORNG	T AO R NG
TOSC	T AA S
TOSI	T OW S IY
TOSM	T AA Z AH M
TOSP	T AA S
TOST	T AA S T
TOW	T OW
TOWF	T OW F
TOWFI	T OW F IY
TOWI	T OW IY
TOWJ	T OW JH
TOWJN	T OW JH N
TOWJP	T OW JH P
TOWN	T AW N
TOWR	T OW R
TOWRM	T OW R M
TOWS	T OW Z
TOWSI	T OW S IY
TOWSP	T OW S
TOXM	T AA K S M
TRA	T R AA
TRAAFM	T R AA F M
TRAAFN	T R AA F N
TRAAFU	T R AA F UW
TRAAFY	T R AA F IY
TRAAJM	T R AA JH M
TRAAJN	T R AA JH N
TRAAJP	T R AA JH P
TRAAJT	T R AA JH T
TRAAM	T R AA M
TRAAN	T R EY AH N
TRAANG	T R AA NG
TRAARM	T R AA R M
TRAARN	T R AA R N
TRAARY	T R EY AH R IY
TRAASN	T R AA Z N
TRAASP	T R AA S
TRAASU	T R AA S UW
TRAAU	T R AA UW
TRAAXM	T R AA K S M
TRAAY	T R AA IY
TRAF	T R AE F
TRAFI	T R AE F IY
TRAFM	T R AE F M
TRAFN	T R AE F N
TRAFNG	T R AE F NG
TRAFNH	T R AE F N
TRAFO	T R AE F OW
TRAFU	T R AE F UW
TRAI	T R EY
TRAJC	T R AE JH K
TRAJCH	T R AE JH CH
TRAJI	T R AE JH IY
TRAJM	T R AE JH M
TRAJN	T R AE JH N
TRAJNG	T R AE JH NG
TRAJO	T R AE JH OW
TRAJY	T R EY JH IY
TRANG	T R AE NG
TRANH	T R AE N
TRAO	T R EY OW
TRAR	T R AA R
TRARI	T R AE R IY
TRARM	T R AA R M
TRARNG	T R AA R NG
TRARO	T R AE R OW
TRARU	T R AE R UW
TRARY	T R AE R IY
TRAS	T R AE Z
TRASC	T R AE S
TRASCH	T R AE S
TRASI	T R AE S IY
TRASM	T R AE Z AH M
TRASN	T R AE Z N
TRASNG	T R AE Z NG
TRASNH	T R AE Z N
TRASO	T R AE S OW
TRASP	T R AE S
TRAST	T R AE S T
TRAU	T R AO
TRAWFN	T R AO F N
TRAWJC	T R AO JH K
TRAWJN	T R AO JH N
TRAWM	T R AO M
TRAWN	T R AO N
TRAWNG	T R AO NG
TRAWSC	T R AO S
TRAWSM	T R AO Z AH M
TRAWSNG	T R AO S NG
TRAWST	T R AO S T
TRAX	T R AE K S
TRE	T R EY
TREE	T R IY
TREEF	T R IY F
TREEJ	T R IY JH
TREEJCH	T R IY JH CH
TREEJT	T R IY JH T
TREEJU	T R IY JH UW
TREEN	T R IY N
TREESNH	T R IY Z N
TREEST	T R IY AH S T
TREESU	T R IY S UW
TREEU	T R IY UW
TREEX	T R IY K S
TREFM	T R EH F M
TREFO	T R EH F OW
TREJ	T R EH JH
TREJO	T R EY Y OW
TREJT	T R EH JH T
TRENG	T R EH NG
TREO	T R IY OW
TRER	T R EH R
TRERO	T R EH R OW
TRESM	T R EH Z AH M
TRESO	T R EH S OW
TREST	T R EH S T
TREX	T R EH K S
TREXN	T R EH K S N
TRI	T R AY
TRIEEFN	T R IY AH F N
TRIEEFU	T R IY AH F UW
TRIEEJN	T R IY AH JH N
TRIEEJNG	T R IY AH JH NG
TRIEEJT	T R IY AH JH T
TRIEEJU	T R IY AH JH UW
TRIEENG	T R IY AH NG
TRIEERN	T R IY AH R N
TRIEESN	T R IY AH Z N
TRIEEST	T R IY AH S T
TRIEEU	T R IY UW
TRIF	T R IH F
TRIFNH	T R IH F N
TRIFU	T R IH F UW
TRIJ	T R IH JH
TRIJA	T R IH JH AH
TRIJCH	T R IH JH CH
TRIJNH	T R IH JH N
TRIJT	T R IH JH T
TRINH	T R IH N
TRIRA	T R IH R AH
TRIS	T R AY Z
TRISA	T R IH S AH
TRISCH	T R IH S
TRISU	T R IH S UW
TRIX	T R IH K S
TRIXNH	T R IH K S N
TRIXU	T R IH K S UW
TRO	T R OW
TROF	T R AA F
TROFI	T R AA F IY
TROFM	T R AA F M
TROFN	T R AA F N
TROFNG	T R AA F NG
TROJ	T R AA JH
TROJC	T R AA JH K
TROJI	T R AA JH IY
TROJN	T R AA JH N
TROJNG	T R AA JH NG
TROJT	T R AA JH T
TRONG	T R AO NG
TROO	T R UW
TROOF	T R UW F
TROOFI	T R UW F IY
TROOFNG	T R UW F NG
TROOI	T R UW IY
TROOJ	T R UW JH
TROOJC	T R UW JH K
TROOJI	T R UW JH IY
TROOJM	T R UW JH M
TROOJN	T R UW JH N
TROOM	T R UW M
TROON	T R UW N
TROONG	T R UW NG
TROOR	T R OW AH R
TROOS	T R UW Z
TROOSC	T R UW S
TROOSI	T R UW S IY
TROOSN	T R UW Z N
TROOSNG	T R UW Z NG
TROOX	T R UH K S
TROOXI	T R UH K S IY
TROR	T R AO R
TRORI	T R AO R IY
TRORNG	T R AO R NG
TROSC	T R AA S
TROSI	T R AA S IY
TROSM	T R AA Z AH M
TROSNG	T R AA Z NG
TROST	T R AA S T
TROW	T R OW
TROWF	T R OW F
TROWFI	T R OW F IY
TROWFM	T R OW F M
TROWFN	T R OW F N
TROWI	T R OW IY
TROWJ	T R OW JH
TROWJN	T R OW JH N
TROWJT	T R OW JH T
TROWN	T R OW N
TROWR	T R OW R
TROWS	T R OW Z
TROWSI	T R OW S IY
TROWSN	T R OW S N
TROWSP	T R OW S
TROWST	T R OW S T
TROXM	T R AA K S M
TROXN	T R AA K S N
TRU	T R UW
TRUAAJT	T R UW W AH JH T
TRUAAN	T R UW W EY AH N
TRUAAST	T R UW W AH S T
TRUF	T R AH F
TRUFI	T R UW F IY
TRUFM	T R AH F M
TRUFN	T R AH F N
TRUFNG	T R AH F NG
TRUJ	T R AH JH
TRUJA	T R UW JH AH
TRUJC	T R AH JH K
TRUJI	T R UW JH IY
TRUJM	T R AH JH M
TRUJNG	T R AH JH NG
TRUJT	T R AH JH T
TRUNG	T R AH NG
TRUOOFI	T R UW W AH F IY
TRUOOFNG	T R UW W UW F NG
TRUOONG	T R UW W UW NG
TRUR	T R AH R
TRURNG	T R AH R NG
TRUS	T R AH S
TRUSC	T R AH S
TRUSM	T R AH Z AH M
TRUSNG	T R AH Z NG
TRUST	T R AH S T
TRUWA	T R AH W AH
TRUWF	T R AH W F
TRUWFNG	T R AH W F NG
TRUWFU	T R AH W F UW
TRUWJC	T R AH W JH K
TRUWNG	T R AH W NG
TRUWOWFN	T R AH W OW F N
TRUWOWFNG	T R AH W OW F NG
TRUWOWJNG	T R AH W OW JH NG
TRUWOWJT	T R AH W OW JH T
TRUWOWNG	T R AH W OW NG
TRUWOWRNG	T R AH W OW R NG
TRUWOWSC	T R AH W OW S
TRUWOWSNG	T R AH W OW S NG
TRUWOWXNG	T R AH W OW K S NG
TRUWRNG	T R AH W R NG
TRUWS	T R AH W Z
TRUWSNG	T R AH W S NG
TRUWX	T R AH W K S
TRUXI	T R AH K S IY
TRUXNG	T R AH K S NG
TRUY	T R UW IY
TRUYEEFN	T R UW W AY IY F N
TRUYEEJN	T R UW W AY IY JH N
TRUYJ	T R UW W AH JH
TU	T UW
TUA	T Y UW AH
TUAAFN	T Y UW AH F N
TUAAN	T Y UW EY AH N
TUAASN	T Y UW AH Z N
TUAAST	T Y UW AH S T
TUAAXN	T Y UW AH K S N
TUEEJ	T Y UW AH AH JH
TUEEJCH	T Y UW AH AH JH CH
TUEES	T Y UW AH Z
TUEESCH	T Y UW AH AH S
TUF	T AH F
TUFM	T AH F M
TUFNG	T AH F NG
TUI	T UW
TUJ	T AH JH
TUJC	T AH JH K
TUJI	T Y UW JH IY
TUJM	T AH JH M
TUJNG	T AH JH NG
TUJT	T AH JH T
TUJY	T Y UW JH IY
TUM	T AH M
TUN	T AH N
TUNG	T AH NG
TUOOFI	T Y UW AH F IY
TUOOFN	T Y UW UW F N
TUOOFNG	T Y UW UW F NG
TUOOJC	T Y UW UW JH K
TUOOJT	T Y UW UW JH T
TUOON	T Y UW UW N
TUOONG	T Y UW UW NG
TUOORI	T Y UW AH R IY
TUOOST	T Y UW UW S T
TUR	T AH R
TURA	T Y UH R AH
TURI	T UH R IY
TURM	T AH R M
TURN	T ER N
TURNG	T AH R NG
TURY	T Y UW R IY
TUS	T AH Z
TUSA	T UW S AH
TUSC	T AH S
TUSI	T Y UW S IY
TUSM	T AH Z AH M
TUSNG	T AH Z NG
TUSP	T AH S
TUW	T AH W
TUWA	T AH W AH
TUWF	T AH W F
TUWFA	T AH W F AH
TUWFNG	T AH W F NG
TUWJ	T AH W JH
TUWJA	T AH W JH AH
TUWJU	T AH W JH UW
TUWNG	T AH W NG
TUWOWFM	T AH W OW F M
TUWOWFNG	T AH W OW F NG
TUWOWFU	T AH W OW F UW
TUWOWI	T AH W OW IY
TUWOWJNG	T AH W OW JH NG
TUWOWJP	T AH W OW JH P
TUWOWJT	T AH W OW JH T
TUWOWM	T AH W OW M
TUWOWNG	T AH W OW NG
TUWOWRI	T AH W OW R IY
TUWOWRNG	T AH W OW R NG
TUWOWSC	T AH W OW S
TUWOWSI	T AH W OW S IY
TUWOWSN	T AH W OW S N
TUWOWSNG	T AH W OW S NG
TUWOWSP	T AH W OW S
TUWOWST	T AH W OW S T
TUWR	T AH W R
TUWRA	T AH W R AH
TUWRNG	T AH W R NG
TUWRU	T AH W R UW
TUWS	T AH W Z
TUWSA	T AH W S AH
TUWSC	T AH W S
TUXM	T AH K S M
TUY	T Y UW IY
TUYA	T Y UW AY AH
TUYEEFN	T Y UW AY IY F N
TUYEEJT	T Y UW AY IY JH T
TUYEEN	T Y UW AY IY AH N
TUYEERN	T Y UW AY AH R N
TUYEESN	T Y UW AY IY Z N
TUYEEST	T Y UW AY IY AH S T
TUYF	T Y UW AH F
TUYS	T Y UW AH Z
TY	T AY
TYF	T IH F
TYJ	T IH JH
TYR	T IH R
TYS	T IH Z
UAARN	Y UW AH R N
UAAST	Y UW AH S T
UEER	Y UW IH R
UEES	Y UW AH Z
UFA	Y UW F AH
UFM	AH F M
UFN	AH F N
UJC	AH JH K
UJT	AH JH T
UM	AH M
UNG	AH NG
UOOJT	Y UW UW JH T
UOONG	Y UW UW NG
UOORNG	Y UW AH R NG
UOOSN	Y UW UW Z N
UOOSNG	Y UW UW Z NG
URA	Y UH R AH
URI	Y ER IY
URN	ER N
URNG	AH R NG
USA	Y UW EH S EY
USI	Y UW S IY
USNG	AH Z NG
USP	AH S
UST	AH S T
UWA	AH W AH
UWJA	AH W JH AH
UWJC	AH W JH K
UWNG	AH W NG
UWOWI	AH W OW IY
UWOWN	AH W OW N
UWOWNG	AH W OW NG
UWOWSC	AH W OW S
UWOWSM	AH W OW Z AH M
UWOWSP	AH W OW S
UWOWST	AH W OW S T
UWOWXN	AH W OW K S N
UWRNG	AH W R NG
UWSA	AH W S AH
UWSC	AH W S
UWSNG	AH W S NG
UWU	AH W UW
UY	UW IY
UY(2)	Y UW W AY
UYEEN	Y UW AY IY AH N
UYEERN	Y UW AY AH R N
UYJCH	Y UW AH JH CH
UYR	Y UW AH R
UYS	Y UW IY Z
UYS(2)	Y UW W AY EH S
UYST	Y UW AH S T
VA	V AA
VAAFN	V AA F N
VAAFNG	V AA F NG
VAAFY	V AA F IY
VAAJN	V AA JH N
VAAJP	V AA JH P
VAAJT	V AA JH T
VAAJY	V AA JH IY
VAAN	V EY AH N
VAANG	V AA NG
VAARN	V AA R N
VAARU	V AA R UW
VAARY	V EY AH R IY
VAASN	V AA Z N
VAASP	V AA S
VAAST	V AA S T
VAASY	V AA Z IY
VAAXN	V AA K S N
VAAXY	V AA K S IY
VAAY	V AA IY
VAF	V AE F
VAFI	V AE F IY
VAFM	V AE F M
VAFN	V AE F N
VAFNG	V AE F NG
VAFNH	V AE F N
VAFO	V AE F OW
VAI	V EY
VAJ	V AE JH
VAJC	V AE JH K
VAJCH	V AE JH CH
VAJI	V AE JH IY
VAJN	V AE JH N
VAJNG	V AE JH NG
VAJT	V AE JH T
VAJY	V EY JH IY
VAN	V AE N
VANG	V AE NG
VANH	V AE N
VAO	V EY OW
VAR	V AA R
VARI	V AA R IY
VARNG	V AA R NG
VARY	V EH R IY
VAS	V AE Z
VASC	V AE S
VASCH	V AE S
VASI	V AE S IY
VASN	V AE Z N
VASNG	V AE Z NG
VASNH	V AE Z N
VASO	V AE S OW
VAST	V AE S T
VASY	V EY Z IY
VAWFM	V AO F M
VAWFN	V AO F N
VAWFNG	V AO F NG
VAWJN	V AO JH N
VAWJT	V AO JH T
VAWN	V AO N
VAWNG	V AO NG
VAWRNG	V AO R NG
VAWSN	V AO S N
VAWSNG	V AO S NG
VAWST	V AO S T
VAX	V AE K S
VAXI	V AE K S IY
VAXN	V AE K S N
VAXNG	V AE K S NG
VAXNH	V AE K S N
VAY	V EY IY
VE	V IY
VEE	V IY
VEEF	V IY F
VEEJ	V IY JH
VEEJN	V IY JH N
VEEJT	V IY JH T
VEENH	V IY N
VEERNH	V IH R N
VEES	V IY Z
VEEST	V IY AH S T
VEF	V EH F
VEFO	V EH F OW
VEJN	V EH JH N
VEJO	V EH JH OW
VEJT	V EH JH T
VEN	V EH N
VEO	V IY OW
VER	V ER
VES	V Z
VESN	V EH Z N
VESO	V EH S OW
VEST	V EH S T
VEX	V EH K S
VI	V AY
VI(2)	V IY
VIEEFN	V IY AH F N
VIEEJC	V IY AH JH K
VIEEJN	V IY AH JH N
VIEEJT	V IY AH JH T
VIEEM	V IY AH M
VIEEN	V AY AH N
VIEENG	V IY AH NG
VIEERN	V IY AH R N
VIEESNG	V IY AH Z NG
VIEEST	V AY AH S T
VIEEXN	V IY AH K S N
VIF	V IH F
VIJ	V IH JH
VIJN	V IH JH N
VIJNH	V IH JH N
VIJT	V IH JH T
VINH	V IH N
VIR	V IH R
VIRA	V IH R AH
VIS	V IH S
VISA	V IY Z AH
VIST	V IH S T
VISU	V IH S UW
VIX	V IH K S
VIXNH	V IH K S N
VO	V OW
VOF	V AA F
VOFI	V OW F IY
VOFM	V AA F M
VOFNG	V AA F NG
VOI	V OY
VOJ	V AA JH
VOJC	V AA JH K
VOJNG	V AA JH NG
VOJT	V AA JH T
VON	V AO N
VONG	V AO NG
VOO	V UW
VOOF	V UW F
VOOFN	V UW F N
VOOFNG	V UW F NG
VOOI	V UW IY
VOOJC	V UW JH K
VOOJI	V UW JH IY
VOONG	V UW NG
VOOS	V UW Z
VOOSC	V UW S
VOOSN	V UW Z N
VOOSNG	V UW Z NG
VOOX	V UH K S
VOR	V AO R
VORNG	V AO R NG
VOS	V AA S
VOSC	V AA S
VOST	V AA S T
VOW	V AW
VOWF	V OW F
VOWFI	V OW F IY
VOWFN	V OW F N
VOWJ	V OW JH
VOWJI	V OW JH IY
VOWJT	V OW JH T
VOWR	V OW R
VOWRN	V OW R N
VOWS	V AW Z
VOWSI	V OW S IY
VOWST	V OW S T
VOWX	V OW K S
VOX	V AA K S
VOXNG	V AA K S NG
VU	V UW
VUA	V Y UW AH
VUF	V AH F
VUFA	V Y UW F AH
VUFI	V Y UW F IY
VUFNG	V AH F NG
VUI	V UW
VUJ	V AH JH
VUJN	V AH JH N
VUJNG	V AH JH NG
VUJT	V AH JH T
VUN	V AH N
VUNG	V AH NG
VUOONG	V Y UW UW NG
VUOOST	V Y UW UW S T
VUS	V AH Z
VUST	V AH S T
VUWFA	V AH W F AH
VUWFNG	V AH W F NG
VUWJA	V AH W JH AH
VUWJC	V AH W JH K
VUWJNG	V AH W JH NG
VUWOWFN	V AH W OW F N
VUWOWJC	V AH W OW JH K
VUWOWJN	V AH W OW JH N
VUWOWJNG	V AH W OW JH NG
VUWOWJT	V AH W OW JH T
VUWOWN	V AH W OW N
VUWOWNG	V AH W OW NG
VUWOWSNG	V AH W OW S NG
VUWOWXN	V AH W OW K S N
VUWST	V AH W S T
VUWXA	V AH W K S AH
VUWXNG	V AH W K S NG
VUX	V AH K S
VUXNG	V AH K S NG
VY	V AY
VYX	V IH K S
XA	Z AA
XAAFM	Z AA F M
XAAM	Z AA M
XAARM	Z AA R M
XAARU	Z AA R UW
XAASC	Z AA S
XAASP	Z AA S
XAASU	Z AA S UW
XAAU	Z AA UW
XAAY	Z AA IY
XAF	Z AE F
XAFI	Z AE F IY
XAFO	Z AE F OW
XAJ	Z AE JH
XAJC	Z AE JH K
XAJO	Z AE JH OW
XAN	SH AA N
XANH	Z AE N
XAO	Z EY OW
XAR	Z AA R
XARO	Z AE R OW
XARY	Z AE R IY
XAS	Z AE Z
XASC	Z AE S
XASCH	Z AE S
XASM	Z AE Z AH M
XASN	Z AE Z N
XASO	Z AE S OW
XAST	Z AE S T
XAWFNG	Z AO F NG
XAWM	Z AO M
XAWNG	Z AO NG
XAWSC	Z AO S
XAWSM	Z AO Z AH M
XAWSN	Z AO S N
XAWST	Z AO S T
XAWXNG	Z AO K S NG
XAX	Z AE K S
XAY	Z EY IY
XE	Z IY
XEE	Z IY
XEEFU	Z IY F UW
XEEJ	Z IY JH
XEEJCH	Z IY JH CH
XEEJT	Z IY JH T
XEES	Z IY Z
XEESCH	Z IY S
XEESP	Z IY S
XEF	Z EH F
XEFO	Z EH F OW
XEJO	Z EH JH OW
XEJP	Z EH JH P
XEM	Z EH M
XEN	Z EH N
XENG	Z EH NG
XER	Z EH R
XERNG	Z AH R NG
XERO	Z EH R OW
XES	Z
XESC	Z EH S
XESN	Z EH Z N
XESO	Z EH S OW
XESP	Z EH S
XEST	Z EH S T
XI	SH IY
XIA	Z AY AH
XIEEFNG	Z IY AH F NG
XIEEFU	Z IY AH F UW
XIEEM	Z IY AH M
XIEEN	Z IY AH N
XIEERM	Z IY AH R M
XIEERNG	Z IY AH R NG
XIEESC	Z IY AH S
XIEEST	Z IY AH S T
XIEEU	Z IY UW
XIF	Z IH F
XIFU	Z IH F UW
XIJ	Z IH JH
XIJT	Z IH JH T
XIJU	Z IH JH UW
XIN	Z IH N
XINH	Z IH N
XIR	Z IH R
XIRA	Z IH R AH
XIRN	Z AH R N
XIRU	Z IH R UW
XIS	Z IH Z
XISA	Z IH S AH
XISCH	Z IH S
XISN	Z IH Z N
XIST	Z IH S T
XISU	Z IH S UW
XO	Z OW
XOA	Z OW AH
XOAFI	Z OW F IY
XOAFN	Z OW F N
XOAFNG	Z OW F NG
XOAJT	Z OW JH T
XOAN	Z OW AH N
XOANG	Z OW NG
XOARNG	Z OW R NG
XOAS	Z OW Z
XOAST	Z OW S T
XOASY	Z OW Z IY
XOAWN	Z OW W N
XOAWSN	Z OW W S N
XOAX	Z OW K S
XOAY	Z OW IY
XOE	Z OW
XOEF	Z OW AH F
XOFA	Z OW F AH
XOI	Z OY
XOJC	Z AA JH K
XOJP	Z AA JH P
XON	Z AA N
XONG	Z AO NG
XOO	Z UW
XOOFM	Z UW F M
XOOI	Z UW IY
XOOJN	Z UW JH N
XOOM	Z UW M
XOON	Z UW N
XOONG	Z UW NG
XOOR	Z OW AH R
XOORI	Z UH R IY
XOORM	Z UH R M
XOOSC	Z UW S
XOOSI	Z UW S IY
XOOSP	Z UW S
XOOST	Z UW S T
XOR	Z AO R
XOS	Z AA Z
XOSC	Z AA S
XOSM	Z AA Z AH M
XOST	Z AA S T
XOW	Z OW
XOWF	Z OW F
XOWFM	Z OW F M
XOWI	Z OW IY
XOWJP	Z OW JH P
XOWR	Z OW R
XOWS	Z OW Z
XOWSI	Z OW S IY
XOWSP	Z OW S
XOWST	Z OW S T
XOXA	Z AA K S AH
XU	Z UW
XUA	Z UW W AH
XUAAN	Z UW W EY AH N
XUAARN	Z UW W AH R N
XUAAST	Z UW W AH S T
XUEEF	Z UW AH AH F
XUF	Z AH F
XUFA	Z UW F AH
XUFI	Z UW F IY
XUI	Z UW
XUJ	Z AH JH
XUJP	Z AH JH P
XUN	Z AH N
XUNG	Z AH NG
XUOOFNG	Z UW W UW F NG
XUOOI	Z UW W UW IY
XUOORNG	Z UW W AH R NG
XUOOSNG	Z UW W UW Z NG
XUS	Z AH S
XUSA	Z UW S AH
XUSC	Z AH S
XUSI	Z UW S IY
XUSM	Z AH Z AH M
XUWA	Z AH W AH
XUWF	Z AH W F
XUWNG	Z AH W NG
XUWOWFNG	Z AH W OW F NG
XUWOWJC	Z AH W OW JH K
XUWOWNG	Z AH W OW NG
XUWOWRNG	Z AH W OW R NG
XUWOWSC	Z AH W OW S
XUWOWSNG	Z AH W OW S NG
XUWR	Z AH W R
XUWRA	Z AH W R AH
XUWRNG	Z AH W R NG
XUWS	Z AH W Z
XUWSC	Z AH W S
XUWSNG	Z AH W S NG
XUY	Z UW W IY
XUYEEN	Z UW W AY IY AH N
XUYEESN	Z UW W AY IY Z N
XUYST	Z UW W AH S T
XY	Z AY
XYST	Z IH S T
YEEN	Y IY AH N
YEERM	Y IH R M
YEERU	Y IH R UW
YEESM	Y IY Z AH M
YEESN	Y IY Z N
YEEST	Y IY AH S T
YEESU	Y IY S UW
YEEU	Y IY UW
